Word_low,Frequency,Word_high,Frequency on High-point descriptions,Frequency on Low-point descriptions,high/low,total
will,351,impressive,610,10,61,620
here,283,velvety,498,10,49.8,508
attractive,273,beautifully,476,10,47.6,486
blanc,235,2018,417,10,41.7,427
sweetness,324,beautiful,571,14,40.78571429,585
modest,217,opulent,386,10,38.6,396
opens,214,2020,381,10,38.1,391
quality,198,2018,359,10,35.9,369
do,182,gorgeous,335,10,33.5,345
astringent,174,refined,309,10,30.9,319
way,255,cellar,445,15,29.66666667,460
lively,157,2020,289,10,28.9,299
texture,643,delicious,1024,37,27.67567568,1061
be,497,powerful,850,32,26.5625,882
cranberry,145,2022,264,10,26.4,274
slightly,673,complex,1106,42,26.33333333,1148
wild,141,2019,256,10,25.6,266
its,856,concentrated,1340,55,24.36363636,1395
honey,215,polished,383,16,23.9375,399
what,199,baking,364,16,22.75,380
zin,125,2030,226,10,22.6,236
despite,123,cru,219,10,21.9,229
tangy,236,lovely,418,20,20.9,438
refreshing,115,six,206,10,20.6,216
giving,113,graphite,202,10,20.2,212
oak,1128,years,1781,92,19.35869565,1873
seems,310,develop,542,28,19.35714286,570
easy,401,power,676,35,19.31428571,711
should,108,2025,193,10,19.3,203
hints,278,least,480,25,19.2,505
wet,108,brooding,192,10,19.2,202
mildly,108,site,192,10,19.2,202
aromatic,108,wonderful,192,10,19.2,202
needs,106,2025,188,10,18.8,198
straightforward,106,decade,187,10,18.7,197
otherwise,106,backbone,187,10,18.7,197
rounded,106,planted,186,10,18.6,196
raspberries,105,compelling,186,10,18.6,196
juice,220,potential,390,21,18.57142857,411
less,105,lavender,185,10,18.5,195
acid,105,stunning,185,10,18.5,195
savory,144,focused,258,14,18.42857143,272
yellow,104,star,184,10,18.4,194
gentle,103,mountain,184,10,18.4,194
too,504,elegant,864,47,18.38297872,911
neutral,102,fine-grained,183,10,18.3,193
now,793,vineyard,1220,67,18.20895522,1287
skin,102,luscious,181,10,18.1,191
going,140,tightly,253,14,18.07142857,267
mocha,102,excellent,180,10,18,190
they,100,grand,178,10,17.8,188
intense,100,slowly,175,10,17.5,185
caramel,230,layered,400,23,17.39130435,423
tea,98,succulent,173,10,17.3,183
firm,192,vineyards,355,21,16.9047619,376
carry,96,richly,169,10,16.9,179
rough,188,vines,349,21,16.61904762,370
olive,93,sample,165,10,16.5,175
little,685,long,1109,68,16.30882353,1177
grenache,91,wonderfully,161,10,16.1,171
sirah,91,enticing,161,10,16.1,171
flavor,657,structured,1070,67,15.97014925,1137
front,135,taut,238,15,15.86666667,253
quickly,89,2023,157,10,15.7,167
set,88,superb,157,10,15.7,167
gritty,148,winemaker,265,17,15.58823529,282
back,87,6,153,10,15.3,163
spices,86,underbrush,151,10,15.1,161
open,85,finely,150,10,15,160
fairly,125,thyme,224,15,14.93333333,239
medium-bodied,177,violet,321,22,14.59090909,343
perfumed,113,purity,203,14,14.5,217
cola,236,next,420,29,14.48275862,449
dense,81,seductive,144,10,14.4,154
yet,144,integrated,258,18,14.33333333,276
forward,77,single-vineyard,142,10,14.2,152
gets,76,heady,141,10,14.1,151
stewy,76,barolo,141,10,14.1,151
popcorn,75,2019,140,10,14,150
white,687,dense,1126,81,13.90123457,1207
hint,321,layers,567,41,13.82926829,608
unbalanced,73,massive,137,10,13.7,147
delicate,92,violets,162,12,13.5,174
medicinal,158,until,294,22,13.36363636,316
both,110,soil,200,15,13.33333333,215
snappy,73,truffle,133,10,13.3,143
light-bodied,73,4,133,10,13.3,143
intensity,72,pipe,132,10,13.2,142
accents,72,doles,132,10,13.2,142
tannin,104,further,184,14,13.14285714,198
easygoing,72,chopped,131,10,13.1,141
make,236,estate,419,32,13.09375,451
diluted,71,beauty,130,10,13,140
lemony,127,serious,232,18,12.88888889,250
syrup,70,elegantly,127,10,12.7,137
through,284,generous,505,40,12.625,545
drying,69,waves,126,10,12.6,136
drinkable,68,highlights,125,10,12.5,135
structured,67,petals,123,10,12.3,133
richness,128,balsamic,233,19,12.26315789,252
feels,739,great,1208,99,12.2020202,1307
deep,67,2015,122,10,12.2,132
take,66,alluring,120,10,12,130
bean,66,2024,120,10,12,130
resin,65,8,119,10,11.9,129
away,65,lengthy,119,10,11.9,129
petit,65,tension,119,10,11.9,129
expression,64,slate,118,10,11.8,128
meat,63,exceptional,115,10,11.5,125
valley,62,deliciously,114,10,11.4,124
racy,62,2022,114,10,11.4,124
midpalate,62,developing,114,10,11.4,124
structure,328,minerality,578,51,11.33333333,629
first,113,pomegranate,204,18,11.33333333,222
never,61,cardamom,113,10,11.3,123
apples,108,framed,191,17,11.23529412,208
who,61,wound,112,10,11.2,122
interesting,61,his,112,10,11.2,122
ros,272,pure,473,43,11,516
skins,78,cake,142,13,10.92307692,155
dishes,59,fennel,109,10,10.9,119
char,59,incredibly,109,10,10.9,119
months,59,long-term,109,10,10.9,119
onto,58,stony,109,10,10.9,119
hay,58,emerge,108,10,10.8,118
bite,58,impressively,107,10,10.7,117
pale,57,champagne,107,10,10.7,117
currant,347,crushed,606,57,10.63157895,663
astringency,57,notions,106,10,10.6,116
anise,70,pencil,127,12,10.58333333,139
year,57,evolve,105,10,10.5,115
terms,57,2030,105,10,10.5,115
crushed,57,bay,105,10,10.5,115
spice,737,age,1206,115,10.48695652,1321
winery,56,densely,104,10,10.4,114
age,115,density,206,20,10.3,226
accented,56,tilled,103,10,10.3,113
enjoy,55,brilliant,102,10,10.2,112
:,85,nutmeg,151,15,10.06666667,166
pineapple,395,bottling,653,65,10.04615385,718
burgers,54,energy,100,10,10,110
typical,54,nuanced,100,10,10,110
help,53,absolutely,100,10,10,110
10,53,promises,99,10,9.9,109
drunk,53,compote,99,10,9.9,109
scratchy,106,floor,188,19,9.894736842,207
still,194,vibrant,356,36,9.888888889,392
medium,227,elegance,395,40,9.875,435
tar,52,iron,98,10,9.8,108
drinks,52,cellaring,98,10,9.8,108
element,69,continue,127,13,9.769230769,140
nothing,93,firmly,166,17,9.764705882,183
cedar,104,sandalwood,184,19,9.684210526,203
stewed,112,napa,201,21,9.571428571,222
herb,248,lush,439,46,9.543478261,485
meaty,51,penetrating,95,10,9.5,105
dominates,51,continues,95,10,9.5,105
tartness,51,botrytis,95,10,9.5,105
whiff,51,immense,95,10,9.5,105
extremely,50,brunello,94,10,9.4,104
regular,49,block,93,10,9.3,103
limited,49,2023,93,10,9.3,103
volatile,49,premier,93,10,9.3,103
grassy,175,classic,313,34,9.205882353,347
fun,49,rosemary,92,10,9.2,102
weak,48,stylish,92,10,9.2,102
grilled,92,several,164,18,9.111111111,182
direct,48,2028,91,10,9.1,101
strongly,48,single,91,10,9.1,101
cooked,47,2021,90,10,9,100
reduced,47,2024,90,10,9,100
smell,47,dramatic,90,10,9,100
chemical,47,maturity,90,10,9,100
french,47,slender,90,10,9,100
tone,47,framework,90,10,9,100
silky,120,espresso,215,24,8.958333333,239
strained,46,ground,89,10,8.9,99
port,46,tremendous,88,10,8.8,98
lush,46,elderberry,88,10,8.8,98
prosecco,46,among,88,10,8.8,98
lack,102,plush,183,21,8.714285714,204
sulfur,45,tense,87,10,8.7,97
strawberries,45,sophisticated,87,10,8.7,97
unfocused,45,outstanding,87,10,8.7,97
immediately,45,seamless,87,10,8.7,97
blueberry,122,2017,217,25,8.68,242
was,120,2017,217,25,8.68,242
region,44,built,86,10,8.6,96
an,1428,rich,2589,304,8.516447368,2893
mix,139,blue,246,29,8.482758621,275
everyday,192,packed,356,42,8.476190476,398
mark,89,huge,159,19,8.368421053,178
use,43,winemaking,83,10,8.3,93
?,490,intense,823,100,8.23,923
those,107,smoked,189,23,8.217391304,212
sugared,42,cuv,82,10,8.2,92
bubbles,42,parcel,82,10,8.2,92
lot,138,supple,245,30,8.166666667,275
after,88,sourced,155,19,8.157894737,174
fare,67,minerals,122,15,8.133333333,137
weird,41,sites,81,10,8.1,91
moscato,41,amazing,81,10,8.1,91
100,66,deeply,121,15,8.066666667,136
edge,304,deep,539,67,8.044776119,606
barely,104,perfect,185,23,8.043478261,208
sangiovese,80,lifted,144,18,8,162
cherry-berry,41,blueberries,80,10,8,90
grapy,41,youthfully,80,10,8,90
air,41,ageworthy,80,10,8,90
buttery,93,de,166,21,7.904761905,187
mulchy,41,rock,79,10,7.9,89
soupy,50,satisfying,94,12,7.833333333,106
rose,64,within,117,15,7.8,132
due,41,thanks,78,10,7.8,88
choice,41,opulence,78,10,7.8,88
ample,41,tiny,78,10,7.8,88
syrupy,118,5,210,27,7.777777778,237
caramelized,54,cr,101,13,7.769230769,114
bad,88,against,155,20,7.75,175
underripe,116,finesse,209,27,7.740740741,236
grass,83,perfectly,147,19,7.736842105,166
;,280,rose,493,64,7.703125,557
prunes,40,sagebrush,77,10,7.7,87
maybe,40,decadent,77,10,7.7,87
elegance,40,luxurious,77,10,7.7,87
score,40,precise,77,10,7.7,87
soda,40,decades,77,10,7.7,87
provide,40,near,77,10,7.7,87
vineyard,67,complete,122,16,7.625,138
smells,382,complexity,646,85,7.6,731
add,40,enormous,76,10,7.6,86
approachable,40,shines,76,10,7.6,86
dominant,57,ever,106,14,7.571428571,120
tangerine,99,e,174,23,7.565217391,197
tannic,589,aging,960,127,7.559055118,1087
been,85,loaded,151,20,7.55,171
being,61,named,113,15,7.533333333,128
cab,169,provide,301,40,7.525,341
raisin,155,forest,283,38,7.447368421,321
gooseberry,59,three,111,15,7.4,126
lingering,39,crafted,74,10,7.4,84
such,39,muscular,74,10,7.4,84
inviting,38,iris,74,10,7.4,84
ultimately,38,hill,74,10,7.4,84
crispness,64,nuances,118,16,7.375,134
rest,38,douro,73,10,7.3,83
offset,38,textural,73,10,7.3,83
chocolaty,38,utterly,73,10,7.3,83
concentrated,55,heart,102,14,7.285714286,116
lemon,470,mineral,794,109,7.28440367,903
offer,74,intriguing,138,19,7.263157895,157
get,154,lingering,283,39,7.256410256,322
grapes,175,bold,312,43,7.255813953,355
pepper,468,should,780,108,7.222222222,888
reminiscent,38,powerfully,72,10,7.2,82
italian,38,2015,72,10,7.2,82
water,37,2009,72,10,7.2,82
gold,37,nebbiolo,72,10,7.2,82
oddly,37,shine,72,10,7.2,82
metallic,37,mulberry,72,10,7.2,82
raisiny,140,produced,251,35,7.171428571,286
sip,44,2012,86,12,7.166666667,98
personality,37,velvet,71,10,7.1,81
blossom,37,chalk,71,10,7.1,81
40,37,2027,71,10,7.1,81
asparagus,84,stage,148,21,7.047619048,169
prickly,57,3,105,15,7,120
surprisingly,53,linger,98,14,7,112
tongue,36,flinty,70,10,7,80
adequate,36,l,70,10,7,80
tastes,858,firm,1343,192,6.994791667,1535
fruitiness,144,length,258,37,6.972972973,295
heat,140,hold,251,36,6.972222222,287
tough,201,exotic,369,53,6.962264151,422
version,36,voluptuous,69,10,6.9,79
prime,36,2026,69,10,6.9,79
follows,36,delivering,69,10,6.9,79
common,36,hills,69,10,6.9,79
brown,68,ginger,124,18,6.888888889,142
butter,64,modern,117,17,6.882352941,134
one-dimensional,71,mouthwatering,130,19,6.842105263,149
flabby,92,family,164,24,6.833333333,188
delivers,96,five,170,25,6.8,195
say,35,ethereal,68,10,6.8,78
definition,35,attention,68,10,6.8,78
mourv,58,four,108,16,6.75,124
opening,35,soy,67,10,6.7,77
upfront,35,2021,67,10,6.7,77
power,35,ch,67,10,6.7,77
limes,35,terrific,67,10,6.7,77
amount,41,become,80,12,6.666666667,92
likely,61,promise,113,17,6.647058824,130
style,276,glass,477,72,6.625,549
left,34,hibiscus,66,10,6.6,76
line,34,eight,66,10,6.6,76
lost,34,unctuous,66,10,6.6,76
runs,34,sleek,66,10,6.6,76
nuts,34,peak,66,10,6.6,76
extra,34,seamlessly,66,10,6.6,76
bread,34,mediterranean,66,10,6.6,76
combine,34,pinots,66,10,6.6,76
interest,34,2014,66,10,6.6,76
milk,81,future,145,22,6.590909091,167
friendly,57,meet,105,16,6.5625,121
hard,441,cassis,741,113,6.557522124,854
wide,34,streaks,65,10,6.5,75
minerally,34,sumptuous,65,10,6.5,75
mustard,33,equal,65,10,6.5,75
vinegar,33,fabulous,65,10,6.5,75
faint,63,play,116,18,6.444444444,134
blackberry,579,yet,927,144,6.4375,1071
round,197,winery,359,56,6.410714286,415
brisk,115,appellation,205,32,6.40625,237
powder,33,rocks,64,10,6.4,74
fades,33,2035,64,10,6.4,74
high-toned,33,hugely,64,10,6.4,74
equally,33,exquisite,64,10,6.4,74
small,33,harmonious,64,10,6.4,74
porty,62,release,115,18,6.388888889,133
only,232,already,402,63,6.380952381,465
does,452,new,758,119,6.369747899,877
'll,66,combines,121,19,6.368421053,140
leads,66,easily,121,19,6.368421053,140
touch,588,licorice,952,150,6.346666667,1102
as,1142,through,1795,284,6.320422535,2079
remain,33,exciting,63,10,6.3,73
feline,32,bursting,63,10,6.3,73
ca,32,gorgeously,63,10,6.3,73
barbera,32,finest,63,10,6.3,73
helps,32,impeccable,63,10,6.3,73
flowers,96,steely,170,27,6.296296296,197
tired,57,each,107,17,6.294117647,124
baked,250,anise,440,70,6.285714286,510
not,1179,dark,1854,295,6.284745763,2149
because,49,2010,94,15,6.266666667,109
more,641,balanced,1022,164,6.231707317,1186
mineral,109,another,193,31,6.225806452,224
holds,32,array,62,10,6.2,72
gew,32,retains,62,10,6.2,72
attractively,32,detailed,62,10,6.2,72
horsey,32,2013,62,10,6.2,72
polish,31,oldest,62,10,6.2,72
leaf,67,restrained,123,20,6.15,143
along,308,after,540,88,6.136363636,628
pineapples,87,boysenberry,153,25,6.12,178
characteristics,31,lavish,61,10,6.1,71
pruny,31,primary,61,10,6.1,71
american,31,memorable,61,10,6.1,71
nature,31,crunchy,61,10,6.1,71
drawing,31,mandarin,61,10,6.1,71
completely,31,impresses,61,10,6.1,71
bears,31,br,61,10,6.1,71
beef,38,la,73,12,6.083333333,85
made,339,concentration,602,99,6.080808081,701
mouthfeel,490,time,833,137,6.080291971,970
whole,55,me,103,17,6.058823529,120
grabby,124,sage,224,37,6.054054054,261
could,148,sip,265,44,6.022727273,309
followed,176,10,319,53,6.018867925,372
sour,455,richness,770,128,6.015625,898
pungent,51,sea,96,16,6,112
intensely,31,historic,60,10,6,70
clampy,31,property,60,10,6,70
coconut,31,terroir,60,10,6,70
suggestions,31,complexities,60,10,6,70
fans,31,poise,60,10,6,70
weighty,31,vein,60,10,6,70
no,264,depth,461,77,5.987012987,538
riesling,94,these,167,28,5.964285714,195
down,135,producer,238,40,5.95,278
ends,37,cigar,71,12,5.916666667,83
canned,64,frame,118,20,5.9,138
turning,30,7,59,10,5.9,69
aromatics,30,fudge,59,10,5.9,69
misses,30,santa,59,10,5.9,69
curious,30,2,59,10,5.9,69
appears,30,mirabelle,59,10,5.9,69
blush,30,exuberant,59,10,5.9,69
shape,30,nuance,59,10,5.9,69
superripe,30,crus,59,10,5.9,69
tire,30,poised,59,10,5.9,69
considerable,30,lithe,58,10,5.8,68
clarity,29,owned,58,10,5.8,68
when,29,distinctive,58,10,5.8,68
salad,29,class,58,10,5.8,68
fails,29,bringing,58,10,5.8,68
announce,29,age-worthy,58,10,5.8,68
purple,36,allspice,69,12,5.75,81
chilled,36,meld,69,12,5.75,81
fading,44,river,86,15,5.733333333,101
else,55,every,103,18,5.722222222,121
county,29,peppercorns,57,10,5.7,67
always,29,well-integrated,57,10,5.7,67
relatively,29,flint,57,10,5.7,67
sheer,29,held,57,10,5.7,67
similarly,29,fascinating,57,10,5.7,67
blue,29,explodes,57,10,5.7,67
popular,29,precision,57,10,5.7,67
improve,28,2026,57,10,5.7,67
long,68,eucalyptus,125,22,5.681818182,147
overly,100,intensely,176,31,5.677419355,207
under,35,streamlined,68,12,5.666666667,80
're,51,salt,96,17,5.647058824,113
rich,304,delivers,539,96,5.614583333,635
cold,28,force,56,10,5.6,66
cassis,113,purple,201,36,5.583333333,237
dessert,101,certainly,178,32,5.5625,210
red-berry,88,last,155,28,5.535714286,183
provides,43,supported,83,15,5.533333333,98
hardly,28,shavings,55,10,5.5,65
whiffs,28,lip-smacking,55,10,5.5,65
distinct,28,promising,55,10,5.5,65
country-style,28,woodland,55,10,5.5,65
rise,28,powered,55,10,5.5,65
youthful,28,swathes,55,10,5.5,65
plummy,28,important,55,10,5.5,65
center,28,delicately,55,10,5.5,65
hickory,28,flashy,55,10,5.5,65
soon,42,meyer,82,15,5.466666667,97
simply,45,additional,87,16,5.4375,103
barbecue,62,petal,114,21,5.428571429,135
compact,28,potpourri,54,10,5.4,64
jasmine,28,defines,54,10,5.4,64
damp,27,swirl,54,10,5.4,64
pith,27,remarkable,54,10,5.4,64
finesse,27,gravel,54,10,5.4,64
organic,27,92-94,54,10,5.4,64
carmen,27,dazzling,54,10,5.4,64
go,86,pine,151,28,5.392857143,179
lightly,266,spices,462,86,5.372093023,548
best,163,textured,295,55,5.363636364,350
fine,180,valley,332,62,5.35483871,394
?,2648,black,3656,686,5.329446064,4342
briary,44,laced,85,16,5.3125,101
bold,43,linear,85,16,5.3125,101
gum,43,grace,85,16,5.3125,101
oaky,322,core,568,107,5.308411215,675
lemon-lime,36,potent,69,13,5.307692308,82
TRUE,27,black-skinned,53,10,5.3,63
15,27,truly,53,10,5.3,63
pit,27,extended,53,10,5.3,63
50,27,irresistible,53,10,5.3,63
everything,27,enhanced,53,10,5.3,63
freshly,27,teau,53,10,5.3,63
zest,103,menthol,184,35,5.257142857,219
honeydew,35,nervy,68,13,5.230769231,81
difficult,50,peppercorn,94,18,5.222222222,112
sort,50,liqueur,94,18,5.222222222,112
bitterness,208,intensity,375,72,5.208333333,447
5,27,develops,52,10,5.2,62
steely,27,lasts,52,10,5.2,62
nut,27,deliciousness,52,10,5.2,62
wash,27,estate-grown,52,10,5.2,62
framing,26,clone,52,10,5.2,62
charm,26,decant,52,10,5.2,62
molasses,26,pristine,52,10,5.2,62
brut,26,joy,52,10,5.2,62
verdejo,26,brightness,52,10,5.2,62
half,26,extraordinary,52,10,5.2,62
lees,26,spectacular,52,10,5.2,62
red,1380,?,2547,490,5.197959184,3037
mouth,626,still,1000,194,5.154639175,1194
up,564,fine,923,180,5.127777778,1103
together,67,selection,123,24,5.125,147
pyrazines,26,fill,51,10,5.1,61
pleasure,26,ahead,51,10,5.1,61
applesauce,26,woven,51,10,5.1,61
day,26,begin,51,10,5.1,61
initial,26,fragrance,51,10,5.1,61
particularly,26,moreish,51,10,5.1,61
latex,26,appetizing,51,10,5.1,61
present,26,unwind,51,10,5.1,61
peachy,26,lightness,51,10,5.1,61
initially,26,94,51,10,5.1,61
cheeses,26,enormously,51,10,5.1,61
length,37,2007,71,14,5.071428571,85
anywhere,41,above,81,16,5.0625,97
pithy,183,together,337,67,5.029850746,404
no-fuss,26,blending,50,10,5,60
borderline,25,decanting,50,10,5,60
piercing,25,impeccably,50,10,5,60
vintages,25,plays,50,10,5,60
boysenberry,25,2032,50,10,5,60
stone-fruit,25,loam,50,10,5,60
disjointed,65,asian,119,24,4.958333333,143
bottling,65,wait,119,24,4.958333333,143
jumbled,39,unfold,74,15,4.933333333,89
rubber,127,french,231,47,4.914893617,278
cheese,56,how,103,21,4.904761905,124
fig,25,fantastic,49,10,4.9,59
tonic,25,substantial,49,10,4.9,59
2017,25,incense,49,10,4.9,59
frankly,24,olives,49,10,4.9,59
twice,24,marasca,49,10,4.9,59
innocuous,24,extraordinarily,49,10,4.9,59
extreme,24,thoroughly,49,10,4.9,59
angular,72,15,132,27,4.888888889,159
note,470,vintage,786,162,4.851851852,948
lifesaver,32,rare,63,13,4.846153846,76
citrusy,139,whiff,247,51,4.843137255,298
backed,66,fig,121,25,4.84,146
raw,236,bottle,428,89,4.808988764,517
blended,51,reveals,96,20,4.8,116
inexpensive,37,vivid,72,15,4.8,87
cases,24,allowing,48,10,4.8,58
wayward,24,classically,48,10,4.8,58
affordable,24,seven,48,10,4.8,58
chinese,24,clearly,48,10,4.8,58
family,24,development,48,10,4.8,58
nettle,24,seriously,48,10,4.8,58
petrol,24,c,48,10,4.8,58
stand,24,well-balanced,48,10,4.8,58
control,24,brioche,48,10,4.8,58
where,73,improve,134,28,4.785714286,162
dried,266,alongside,464,97,4.783505155,561
minty,196,many,358,75,4.773333333,433
out,464,best,778,163,4.773006135,941
sharpness,32,balances,62,13,4.769230769,75
looking,28,atop,57,12,4.75,69
ready,330,cinnamon,586,124,4.725806452,710
broad,74,always,137,29,4.724137931,166
point,76,2016,141,30,4.7,171
towards,24,2033,47,10,4.7,57
whose,24,washington,47,10,4.7,57
wait,24,hours,47,10,4.7,57
selection,24,chardonnays,47,10,4.7,57
signs,24,gracefully,47,10,4.7,57
flavorful,24,dazzles,47,10,4.7,57
found,23,energetic,47,10,4.7,57
sourness,23,blancs,47,10,4.7,57
base,23,morello,47,10,4.7,57
ne-style,23,2027,47,10,4.7,57
70,23,stellar,47,10,4.7,57
bubble,23,2031,47,10,4.7,57
punch,23,riserva,47,10,4.7,57
leafy,144,aged,263,56,4.696428571,319
candy,234,barrel,407,87,4.67816092,494
sparkling,99,their,173,37,4.675675676,210
finishes,392,young,649,139,4.669064748,788
pressed,39,inky,74,16,4.625,90
clove,138,top,245,53,4.622641509,298
definitely,36,coastal,69,15,4.6,84
i,23,cracked,46,10,4.6,56
displays,23,explosive,46,10,4.6,56
people,23,farmed,46,10,4.6,56
coarse,23,combining,46,10,4.6,56
puckering,23,graceful,46,10,4.6,56
pronounced,23,amazingly,46,10,4.6,56
alongside,97,need,170,37,4.594594595,207
bodied,142,sense,256,56,4.571428571,312
cinnamon,124,between,223,49,4.551020408,272
seem,168,100,300,66,4.545454545,366
lighter,30,almonds,59,13,4.538461538,72
without,155,meat,284,63,4.507936508,347
pears,64,grown,117,26,4.5,143
becomes,27,youth,54,12,4.5,66
smoked,23,gingerbread,45,10,4.5,55
assertive,23,bursts,45,10,4.5,55
south,23,released,45,10,4.5,55
backdrop,23,magnificent,45,10,4.5,55
bar,23,revealing,45,10,4.5,55
effervescence,23,generosity,45,10,4.5,55
includes,23,marzipan,45,10,4.5,55
dose,23,cabernets,45,10,4.5,55
layered,23,immensely,45,10,4.5,55
detracts,23,radiant,45,10,4.5,55
although,199,most,363,81,4.481481481,444
flat,357,wild,626,141,4.439716312,767
rh,49,reserve,93,21,4.428571429,114
sensations,32,lends,62,14,4.428571429,76
matchstick,27,drive,53,12,4.416666667,65
maple,23,te,44,10,4.4,54
juiciness,23,classy,44,10,4.4,54
e,23,soils,44,10,4.4,54
touched,23,burgundy,44,10,4.4,54
gamy,22,packs,44,10,4.4,54
unoaked,22,clones,44,10,4.4,54
black-cherry,22,darker,44,10,4.4,54
healthy,22,chamomile,44,10,4.4,54
bubblegum,22,since,44,10,4.4,54
sweet-and-sour,22,wealth,44,10,4.4,54
's,3692,from,5112,1163,4.395528805,6275
rustic,345,clove,605,138,4.384057971,743
high,358,savory,630,144,4.375,774
meats,43,richer,83,19,4.368421053,102
gaseous,38,including,74,17,4.352941176,91
decent,177,mature,321,74,4.337837838,395
blast,33,mousse,65,15,4.333333333,80
grapey,33,world,65,15,4.333333333,80
things,66,youthful,121,28,4.321428571,149
apple,914,will,1515,351,4.316239316,1866
red-plum,22,remarkably,43,10,4.3,53
lodi,22,creek,43,10,4.3,53
characteristic,22,ages,43,10,4.3,53
deals,22,moist,43,10,4.3,53
o.k,22,beguiling,43,10,4.3,53
60,22,toastiness,43,10,4.3,53
dust,22,famous,43,10,4.3,53
trace,22,having,43,10,4.3,53
layer,22,long-lasting,43,10,4.3,53
surface,22,ranch,43,10,4.3,53
steak,22,harmony,43,10,4.3,53
prior,22,expertly,43,10,4.3,53
bell,90,blossom,159,37,4.297297297,196
game,40,keeping,77,18,4.277777778,95
pinot,438,freshness,736,173,4.25433526,909
softly,55,longer,102,24,4.25,126
robust,36,persistent,68,16,4.25,84
asphalt,35,hearty,68,16,4.25,84
wo,35,loads,68,16,4.25,84
time,137,year,241,57,4.228070175,298
full,319,full-bodied,566,134,4.223880597,700
serve,30,2008,59,14,4.214285714,73
burst,22,clear,42,10,4.2,52
future,22,standout,42,10,4.2,52
cured,22,lilac,42,10,4.2,52
until,22,parcels,42,10,4.2,52
musky,22,strength,42,10,4.2,52
fortunately,22,saffron,42,10,4.2,52
vineyards,21,gain,42,10,4.2,52
juniper,21,detail,42,10,4.2,52
characterize,21,oregon,42,10,4.2,52
appearance,21,details,42,10,4.2,52
fragrant,59,barrels,109,26,4.192307692,135
edges,46,experience,88,21,4.19047619,109
fresh,861,structure,1369,328,4.173780488,1697
torront,31,providing,62,15,4.133333333,77
minerality,51,assertive,95,23,4.130434783,118
early,34,cool-climate,66,16,4.125,82
two,73,small,136,33,4.121212121,169
try,39,adding,74,18,4.111111111,92
viscous,21,showcases,41,10,4.1,51
means,21,2029,41,10,4.1,51
napa,21,generously,41,10,4.1,51
expected,21,success,41,10,4.1,51
sits,21,scorched,41,10,4.1,51
saline,21,sprightly,41,10,4.1,51
evident,21,lineup,41,10,4.1,51
cut,110,plums,199,49,4.06122449,248
feel,532,one,908,225,4.035555556,1133
compost,54,grippy,100,25,4,125
wrapped,40,range,76,19,4,95
extract,27,turned,52,13,4,65
example,26,verve,52,13,4,65
grainy,21,speaks,40,10,4,50
monotone,21,ageability,40,10,4,50
chewing,21,bottlings,40,10,4,50
clunky,21,sanguine,40,10,4,50
distant,21,iconic,40,10,4,50
petal,21,dark-skinned,40,10,4,50
cuisine,21,alpine,40,10,4,50
stage,21,releases,40,10,4,50
excessive,20,oakville,40,10,4,50
ripened,20,glorious,40,10,4,50
unfortunately,20,tempting,40,10,4,50
choppy,86,beef,151,38,3.973684211,189
franc,128,fragrant,234,59,3.966101695,293
anything,39,2011,75,19,3.947368421,94
ham,35,root,67,17,3.941176471,84
austere,88,boasts,157,40,3.925,197
bracing,26,components,51,13,3.923076923,64
alcohol,407,tobacco,725,185,3.918918919,910
smoky,243,both,431,110,3.918181818,541
light-,20,reduction,39,10,3.9,49
punchy,20,rutherford,39,10,3.9,49
pop,20,supportive,39,10,3.9,49
bulky,20,hands,39,10,3.9,49
creates,20,zestiness,39,10,3.9,49
basically,20,blossoms,39,10,3.9,49
got,20,brawny,39,10,3.9,49
wax,20,wood-aged,39,10,3.9,49
density,20,balsam,39,10,3.9,49
central,20,effortlessly,39,10,3.9,49
restrained,20,proportion,39,10,3.9,49
certain,20,flagship,39,10,3.9,49
frame,20,2040,39,10,3.9,49
herbs,234,yellow,405,104,3.894230769,509
raisins,89,lift,159,41,3.87804878,200
reedy,29,25,58,15,3.866666667,73
lactic,44,layer,85,22,3.863636364,107
clean,449,leather,745,193,3.860103627,938
aftertaste,232,cedar,401,104,3.855769231,505
noir,223,mocha,393,102,3.852941176,495
jelly,40,worth,77,20,3.85,97
thing,33,parts,65,17,3.823529412,82
20,43,black-cherry,84,22,3.818181818,106
pizza,56,everything,103,27,3.814814815,130
form,31,coast,61,16,3.8125,77
blends,20,series,38,10,3.8,48
rudimentary,20,enjoyed,38,10,3.8,48
riper,20,sultry,38,10,3.8,48
reveals,20,explosion,38,10,3.8,48
sonoma,20,state,38,10,3.8,48
stale,19,powerhouse,38,10,3.8,48
stick,19,reward,38,10,3.8,48
sweetened,19,possibly,38,10,3.8,48
salinic,19,remaining,38,10,3.8,48
love,19,umami,38,10,3.8,48
greens,19,dynamic,38,10,3.8,48
underdeveloped,19,2028,38,10,3.8,48
sweeter,19,project,38,10,3.8,48
beginning,19,notion,38,10,3.8,48
benefit,19,ways,38,10,3.8,48
2011,19,exceptionally,38,10,3.8,48
barnyard,86,add,151,40,3.775,191
suggests,71,extra,128,34,3.764705882,162
nearly,33,second,64,17,3.764705882,81
party,31,known,60,16,3.75,76
overripe,228,needs,397,106,3.745283019,503
standard,60,considerable,112,30,3.733333333,142
sparkler,58,life,108,29,3.724137931,137
subtle,82,such,145,39,3.717948718,184
freshness,173,subtle,304,82,3.707317073,386
ripeness,84,wrapped,148,40,3.7,188
huge,19,noble,37,10,3.7,47
sourced,19,tons,37,10,3.7,47
green-leaning,19,stunner,37,10,3.7,47
essence,19,integrate,37,10,3.7,47
mushrooms,19,needing,37,10,3.7,47
traditional,19,exquisitely,37,10,3.7,47
soap,19,clos,37,10,3.7,47
balsamic,19,bergamot,37,10,3.7,47
direction,19,intricate,37,10,3.7,47
upon,19,noirs,37,10,3.7,47
red-currant,19,greatest,37,10,3.7,47
richer,19,knit,37,10,3.7,47
think,19,sp,37,10,3.7,47
mouthwatering,19,grounds,37,10,3.7,47
suggesting,43,mellow,85,23,3.695652174,108
sensation,24,black-plum,48,13,3.692307692,61
spritz,24,area,48,13,3.692307692,61
kiwi,30,allow,59,16,3.6875,75
grip,37,beginning,70,19,3.684210526,89
dre,56,lingers,103,28,3.678571429,131
red-fruit,117,elements,209,57,3.666666667,266
pasta,34,earthiness,66,18,3.666666667,84
one,225,aromatic,394,108,3.648148148,502
blackberries,174,:,310,85,3.647058824,395
melony,67,combine,124,34,3.647058824,158
carob,36,mushrooms,69,19,3.631578947,88
mature,74,inviting,137,38,3.605263158,175
barrel-fermented,18,ability,36,10,3.6,46
acrid,18,surrounded,36,10,3.6,46
maderized,18,hedonistic,36,10,3.6,46
sweet-tasting,18,roast,36,10,3.6,46
pickle,18,sources,36,10,3.6,46
several,18,expansive,36,10,3.6,46
every,18,restraint,36,10,3.6,46
overlay,18,nonetheless,36,10,3.6,46
saturated,18,often,36,10,3.6,46
pinch,18,92,36,10,3.6,46
brine,18,deft,36,10,3.6,46
said,18,endless,36,10,3.6,46
flavored,52,totally,97,27,3.592592593,124
tasted,44,fermented,86,24,3.583333333,110
ride,22,apparent,43,12,3.583333333,55
menthol,35,marmalade,68,19,3.578947368,87
jumpy,49,bracing,93,26,3.576923077,119
body,237,wines,429,121,3.545454545,550
cotton,23,mouthfilling,46,13,3.538461538,59
off-dry,125,expression,225,64,3.515625,289
carries,52,compact,98,28,3.5,126
stem,22,road,42,12,3.5,54
jellied,18,rocky,35,10,3.5,45
loses,18,evolution,35,10,3.5,45
dimension,18,lifts,35,10,3.5,45
medium-sweet,18,meets,35,10,3.5,45
mingle,18,century,35,10,3.5,45
native,18,marjoram,35,10,3.5,45
conveys,18,flamboyant,35,10,3.5,45
ideal,18,domaine,35,10,3.5,45
release,18,captivating,35,10,3.5,45
disappointment,18,95,35,10,3.5,45
serious,18,ava,35,10,3.5,45
peppercorn,18,immediate,35,10,3.5,45
integrated,18,incredible,35,10,3.5,45
play,18,major,35,10,3.5,45
earthiness,18,18,35,10,3.5,45
local,18,sniff,35,10,3.5,45
obvious,18,worthy,35,10,3.5,45
semisweet,44,vintages,87,25,3.48,112
apricots,64,line,118,34,3.470588235,152
sweet,1852,ripe,3026,873,3.466208477,3899
end,216,smoke,384,111,3.459459459,495
fruits,809,well,1291,374,3.451871658,1665
throughout,53,yeast,100,29,3.448275862,129
appear,32,',62,18,3.444444444,80
peaches,93,california,165,48,3.4375,213
spent,24,entry,48,14,3.428571429,62
peach,554,so,918,268,3.425373134,1186
see,21,layering,41,12,3.416666667,53
suggest,139,old,249,73,3.410958904,322
mushroom,54,2016,102,30,3.4,132
produced,35,sonoma,68,20,3.4,88
campfire,18,proving,34,10,3.4,44
bone-dry,18,awesome,34,10,3.4,44
stays,17,chablis,34,10,3.4,44
pulse,17,dance,34,10,3.4,44
pork,17,savor,34,10,3.4,44
chenin,17,silk,34,10,3.4,44
medium-weight,17,demands,34,10,3.4,44
promise,17,toned,34,10,3.4,44
special,17,delightful,34,10,3.4,44
parts,17,source,34,10,3.4,44
yield,17,des,34,10,3.4,44
peas,17,latest,34,10,3.4,44
second,17,9,34,10,3.4,44
chile,17,amarone,34,10,3.4,44
pasty,17,village,34,10,3.4,44
tomatoey,17,75,34,10,3.4,44
chocolate-covered,17,presence,34,10,3.4,44
pointed,17,auslese,34,10,3.4,44
mushy,31,sure,61,18,3.388888889,79
veers,31,mingle,61,18,3.388888889,79
given,57,coconut,105,31,3.387096774,136
heavy,522,dried,898,266,3.37593985,1164
toffee,24,expensive,47,14,3.357142857,61
tart,667,full,1070,319,3.354231975,1389
%,652,juicy,1055,315,3.349206349,1370
bramble,45,example,87,26,3.346153846,113
five,25,beer,50,15,3.333333333,65
beaujolais,25,contrast,50,15,3.333333333,65
devoid,20,manages,40,12,3.333333333,52
pretty,284,earth,502,151,3.324503311,653
lightweight,69,support,126,38,3.315789474,164
remains,32,essence,63,19,3.315789474,82
elements,57,remains,106,32,3.3125,138
big,185,zest,341,103,3.310679612,444
especially,51,focus,96,29,3.310344828,125
eucalyptus,22,home,43,13,3.307692308,56
done,40,displays,76,23,3.304347826,99
kick,34,reveal,66,20,3.3,86
modern,17,effect,33,10,3.3,43
me,17,study,33,10,3.3,43
bouncy,17,signature,33,10,3.3,43
framed,17,kirsch,33,10,3.3,43
firmly,17,maturing,33,10,3.3,43
salt,17,2006,33,10,3.3,43
usually,17,du,33,10,3.3,43
softer,17,superbly,33,10,3.3,43
production,17,various,33,10,3.3,43
drier,17,delicacy,33,10,3.3,43
food-friendly,17,welcome,33,10,3.3,43
sauerkraut,16,finished,33,10,3.3,43
complete,16,kicks,33,10,3.3,43
shrill,16,smoothly,33,10,3.3,43
persistent,16,begins,33,10,3.3,43
allow,16,feet,33,10,3.3,43
waft,16,lusciously,33,10,3.3,43
overpowering,16,pollen,33,10,3.3,43
pruney,16,st.,33,10,3.3,43
above,16,foundation,33,10,3.3,43
grace,16,profound,33,10,3.3,43
ammonia,16,tlese,33,10,3.3,43
jammy,402,smooth,686,208,3.298076923,894
new,119,petit,214,65,3.292307692,279
overall,203,perfumed,372,113,3.292035398,485
balanced,164,peel,296,90,3.288888889,386
pink,119,verdot,213,65,3.276923077,278
across,113,same,203,62,3.274193548,265
tang,41,cases,78,24,3.25,102
alcoholic,20,paste,39,12,3.25,51
off-putting,20,hazelnut,39,12,3.25,51
ribs,20,sets,39,12,3.25,51
bordeaux,69,pressed,126,39,3.230769231,165
cantaloupe,21,tarry,42,13,3.230769231,55
thin,435,over,735,228,3.223684211,963
cutting,29,let,58,18,3.222222222,76
buy,23,put,45,14,3.214285714,59
plastic,49,sheer,93,29,3.206896552,122
sugar,244,coffee,436,136,3.205882353,572
cookies,16,mountains,32,10,3.2,42
briney,16,granite,32,10,3.2,42
montepulciano,16,2005,32,10,3.2,42
baking,16,obviously,32,10,3.2,42
band-aid,16,2014,32,10,3.2,42
zippy,16,pedigree,32,10,3.2,42
others,16,entire,32,10,3.2,42
known,16,lushness,32,10,3.2,42
berry-cherry,16,sublime,32,10,3.2,42
four,16,using,32,10,3.2,42
additional,16,key,32,10,3.2,42
red-cherry,16,evolves,32,10,3.2,42
laced,16,wraps,32,10,3.2,42
consistency,16,succulence,32,10,3.2,42
12,16,thrilling,32,10,3.2,42
quaffable,16,ageable,32,10,3.2,42
room,16,volume,32,10,3.2,42
harvest,16,producing,32,10,3.2,42
cool-climate,16,sexy,32,10,3.2,42
acids,221,blueberry,390,122,3.196721311,512
sawdust,26,12,51,16,3.1875,67
then,214,silky,382,120,3.183333333,502
informal,57,closed,105,33,3.181818182,138
average,27,special,54,17,3.176470588,71
real,38,expressive,73,23,3.173913043,96
),173,before,306,97,3.154639175,403
ending,21,resulting,41,13,3.153846154,54
struggles,32,blends,63,20,3.15,83
adds,71,ample,129,41,3.146341463,170
highly,34,warmth,66,21,3.142857143,87
guava,16,syrahs,31,10,3.1,41
flowery,16,cellared,31,10,3.1,41
polished,16,pulls,31,10,3.1,41
moment,16,fills,31,10,3.1,41
size,16,surely,31,10,3.1,41
meet,16,textbook,31,10,3.1,41
feature,16,sipped,31,10,3.1,41
excessively,15,pleasing,31,10,3.1,41
unpleasant,15,2004,31,10,3.1,41
old-vine,15,crust,31,10,3.1,41
north,15,intrigue,31,10,3.1,41
beer,15,complemented,31,10,3.1,41
spoiled,15,russian,31,10,3.1,41
vivid,15,recent,31,10,3.1,41
textured,55,high-toned,102,33,3.090909091,135
thick,187,first,348,113,3.079646018,461
hinting,21,why,40,13,3.076923077,53
plums,49,aromatics,92,30,3.066666667,122
fail,23,package,46,15,3.066666667,61
nose,1431,its,2618,856,3.058411215,3474
off,269,even,473,155,3.051612903,628
black,686,chocolate,1114,369,3.01897019,1483
bone,43,want,84,28,3,112
brightened,28,saturated,54,18,3,72
substance,27,closes,54,18,3,72
roussanne,22,yes,42,14,3,56
tannat,20,driven,39,13,3,52
balancing,20,starting,39,13,3,52
veggies,15,puts,30,10,3,40
look,15,team,30,10,3,40
moscatel,15,indian,30,10,3,40
tartaric,15,!,30,10,3,40
exactly,15,quinta,30,10,3,40
world,15,selected,30,10,3,40
wanting,15,amidst,30,10,3,40
familiar,15,warmer,30,10,3,40
taut,15,atlas,30,10,3,40
contrast,15,chaparral,30,10,3,40
type,15,exuberance,30,10,3,40
nail,15,blood,30,10,3,40
rioja,15,walla,30,10,3,40
straight,15,invigorating,30,10,3,40
river,15,house,30,10,3,40
redolent,15,smoothness,30,10,3,40
did,15,bolstered,30,10,3,40
unfold,15,deeper,30,10,3,40
rosato,15,elaborate,30,10,3,40
three,15,captures,30,10,3,40
honest,15,honeycomb,30,10,3,40
watery,158,tea,292,98,2.979591837,390
bit,714,all,1191,400,2.9775,1591
low,177,toasty,321,108,2.972222222,429
producer,40,pleasure,77,26,2.961538462,103
but,2848,drink,3823,1292,2.958978328,5115
thus,28,presents,56,19,2.947368421,75
slight,102,keep,182,62,2.935483871,244
sage,37,flesh,70,24,2.916666667,94
briny,185,right,340,117,2.905982906,457
dusty,137,ripeness,244,84,2.904761905,328
cidery,31,place,61,21,2.904761905,82
life,29,riper,58,20,2.9,78
3,15,sizable,29,10,2.9,39
consumers,15,cranberries,29,10,2.9,39
dr.,15,vineyard-designate,29,10,2.9,39
crowd,15,hallmark,29,10,2.9,39
d'avola,15,expresses,29,10,2.9,39
thyme,15,dusting,29,10,2.9,39
sipping,15,supremely,29,10,2.9,39
cocktail,15,mainly,29,10,2.9,39
tinged,15,slightest,29,10,2.9,39
settle,15,blockbuster,29,10,2.9,39
package,15,bing,29,10,2.9,39
providing,15,supporting,29,10,2.9,39
mousse,15,sings,29,10,2.9,39
meyer,15,2013,29,10,2.9,39
supported,15,howell,29,10,2.9,39
widely,15,subtlety,29,10,2.9,39
named,15,firmness,29,10,2.9,39
berries,149,delicate,266,92,2.891304348,358
stainless,25,produce,49,17,2.882352941,66
sweetly,25,production,49,17,2.882352941,66
rugged,51,combination,95,33,2.878787879,128
offers,531,into,901,313,2.878594249,1214
easy-drinking,65,coming,118,41,2.87804878,159
bouquet,185,solid,342,119,2.87394958,461
bottle,89,enjoy,158,55,2.872727273,213
if,222,can,393,137,2.868613139,530
rusty,32,cured,63,22,2.863636364,85
30,32,accessible,63,22,2.863636364,85
lovely,20,luminous,40,14,2.857142857,54
scouring,40,TRUE,77,27,2.851851852,104
odd,95,fully,168,59,2.847457627,227
palate,2654,tannins,3703,1306,2.835375191,5009
resiny,153,around,279,99,2.818181818,378
boasts,40,pith,76,27,2.814814815,103
powdered,30,juniper,59,21,2.80952381,80
field,30,lamb,59,21,2.80952381,80
from,1163,%,1831,652,2.808282209,2483
light,1244,spice,2069,737,2.807327001,2806
starts,110,adds,199,71,2.802816901,270
pool,14,secondary,28,10,2.8,38
display,14,vine,28,10,2.8,38
put,14,alicante,28,10,2.8,38
mouth-puckering,14,m,28,10,2.8,38
sweat,14,highlighted,28,10,2.8,38
uncomplicated,14,maintains,28,10,2.8,38
official,14,gradually,28,10,2.8,38
2007,14,cult,28,10,2.8,38
impress,14,holding,28,10,2.8,38
earn,14,dramatically,28,10,2.8,38
2008,14,perfumes,28,10,2.8,38
purity,14,deftly,28,10,2.8,38
sappy,14,slopes,28,10,2.8,38
struggling,14,he,28,10,2.8,38
stay,14,steve,28,10,2.8,38
severely,14,charcoal,28,10,2.8,38
served,14,hefty,28,10,2.8,38
minor,14,peat,28,10,2.8,38
pick,14,rewarding,28,10,2.8,38
sticks,14,coiled,28,10,2.8,38
yes,14,bottled,28,10,2.8,38
onion,14,sophistication,28,10,2.8,38
marsanne,14,waiting,28,10,2.8,38
spearmint,14,tender,28,10,2.8,38
ordinary,14,countered,28,10,2.8,38
tell,14,days,28,10,2.8,38
weight,180,stone,332,119,2.789915966,451
spring,27,upon,53,19,2.789473684,72
rhubarb,82,tar,145,52,2.788461538,197
heft,20,spiciness,39,14,2.785714286,53
clay,18,super,36,13,2.769230769,49
',18,feral,36,13,2.769230769,49
pie-filling,24,pork,47,17,2.764705882,64
white-fruit,54,grip,102,37,2.756756757,139
mellow,23,moment,44,16,2.75,60
winemaker,17,date,33,12,2.75,45
acid-driven,16,produces,33,12,2.75,45
fast,38,freshly,74,27,2.740740741,101
seafood,27,benefit,52,19,2.736842105,71
southern,31,funk,60,22,2.727272727,82
nice,182,currants,335,123,2.723577236,458
honeysuckle,42,perfume,81,30,2.7,111
heaviness,14,composed,27,10,2.7,37
alive,14,hails,27,10,2.7,37
meals,14,carneros,27,10,2.7,37
persists,14,contribute,27,10,2.7,37
linger,14,veteran,27,10,2.7,37
appetizers,14,twist,27,10,2.7,37
expensive,14,minutes,27,10,2.7,37
cover,14,notable,27,10,2.7,37
purposes,14,supports,27,10,2.7,37
eventually,14,lee,27,10,2.7,37
horse,14,breathing,27,10,2.7,37
organically,14,muscle,27,10,2.7,37
spiciness,14,breadth,27,10,2.7,37
tightly,14,solidly,27,10,2.7,37
cheeseburger,14,allows,27,10,2.7,37
luminous,14,dusted,27,10,2.7,37
occasions,14,gr,27,10,2.7,37
why,13,blocks,27,10,2.7,37
turned,13,kept,27,10,2.7,37
resulting,13,allied,27,10,2.7,37
another,31,maple,62,23,2.695652174,85
hold,36,present,70,26,2.692307692,96
akin,18,losing,35,13,2.692307692,48
apricot,257,comes,451,168,2.68452381,619
herbaceous,100,take,177,66,2.681818182,243
vital,16,sunny,32,12,2.666666667,44
berry,1251,now,2111,793,2.662042875,2904
clumsy,58,own,109,41,2.658536585,150
melon,440,balance,740,279,2.652329749,1019
background,52,black-fruit,98,37,2.648648649,135
dilute,136,brings,241,91,2.648351648,332
rooty,19,bordeaux-style,37,14,2.642857143,51
so,268,showing,470,178,2.640449438,648
burn,49,once,92,35,2.628571429,127
all,400,give,657,250,2.628,907
sauce,61,20,113,43,2.627906977,156
appealing,57,game,105,40,2.625,145
wheaty,21,preserves,42,16,2.625,58
licorice,150,flower,269,103,2.611650485,372
come,279,big,483,185,2.610810811,668
disappointing,31,base,60,23,2.608695652,83
kind,61,provides,112,43,2.604651163,155
well,374,herb,645,248,2.600806452,893
pastry,26,balancing,52,20,2.6,72
sherry,13,needle,26,10,2.6,36
blows,13,bouschet,26,10,2.6,36
tree,13,rum,26,10,2.6,36
bark,13,absolute,26,10,2.6,36
verve,13,reds,26,10,2.6,36
potent,13,change,26,10,2.6,36
indicate,13,mineral-driven,26,10,2.6,36
smokiness,13,tingling,26,10,2.6,36
feral,13,buoyant,26,10,2.6,36
edged,13,energizing,26,10,2.6,36
80,13,ridge,26,10,2.6,36
overwhelming,13,ash,26,10,2.6,36
dimensional,13,ease,26,10,2.6,36
super,13,cooking,26,10,2.6,36
nervy,13,senses,26,10,2.6,36
components,13,producers,26,10,2.6,36
primitivo,13,longtime,26,10,2.6,36
softened,13,vibrantly,26,10,2.6,36
grab,13,d,26,10,2.6,36
driven,13,lies,26,10,2.6,36
starting,13,astonishing,26,10,2.6,36
heavy-handed,13,nectar,26,10,2.6,36
coating,13,grey,26,10,2.6,36
tarry,13,extends,26,10,2.6,36
mendocino,13,owner,26,10,2.6,36
overripeness,13,cabs,26,10,2.6,36
burger,13,delightfully,26,10,2.6,36
mushroomy,13,evolving,26,10,2.6,36
cake,13,phenolic,26,10,2.6,36
black-plum,13,near-perfect,26,10,2.6,36
cr,13,massively,26,10,2.6,36
around,99,leaf,174,67,2.597014925,241
were,42,30,83,32,2.59375,115
next,29,steak,57,22,2.590909091,79
sketchy,31,fermentation,62,24,2.583333333,86
paired,16,surprising,31,12,2.583333333,43
coast,16,exhibits,31,12,2.583333333,43
zesty,124,few,222,86,2.581395349,308
tad,41,hits,80,31,2.580645161,111
once,35,initially,67,26,2.576923077,93
lots,141,tangerine,254,99,2.565656566,353
waxy,67,bacon,123,48,2.5625,171
overoaked,23,box,46,18,2.555555556,64
blend,795,cabernet,1236,484,2.553719008,1720
touches,80,accented,143,56,2.553571429,199
character,718,pepper,1193,468,2.549145299,1661
dominated,69,extremely,127,50,2.54,177
lend,37,center,71,28,2.535714286,99
added,19,redolent,38,15,2.533333333,53
veer,48,robust,91,36,2.527777778,127
fruitless,24,love,48,19,2.526315789,67
main,24,added,48,19,2.526315789,67
ne,29,different,58,23,2.52173913,81
turn,109,chewy,195,78,2.5,273
adding,18,display,35,14,2.5,49
curiously,13,becoming,25,10,2.5,35
snap,13,persistence,25,10,2.5,35
blackened,13,highlight,25,10,2.5,35
says,13,splendid,25,10,2.5,35
equivalent,13,tempered,25,10,2.5,35
following,13,whole-cluster,25,10,2.5,35
poultry,13,signals,25,10,2.5,35
picnics,13,enveloping,25,10,2.5,35
33,13,showcase,25,10,2.5,35
category,13,garrigue,25,10,2.5,35
florals,13,les,25,10,2.5,35
meant,13,exudes,25,10,2.5,35
unlikely,13,fluid,25,10,2.5,35
acacia,13,eastern,25,10,2.5,35
shellfish,13,located,25,10,2.5,35
creaminess,13,usual,25,10,2.5,35
di,13,district,25,10,2.5,35
salads,13,impact,25,10,2.5,35
mouthfilling,13,mace,25,10,2.5,35
pour,13,dosage,25,10,2.5,35
surprising,12,shadings,25,10,2.5,35
mute,12,earl,25,10,2.5,35
shoe,12,retaining,25,10,2.5,35
overriding,12,slope,25,10,2.5,35
downright,12,must,25,10,2.5,35
took,12,original,25,10,2.5,35
none,12,frames,25,10,2.5,35
speak,12,proportioned,25,10,2.5,35
14,12,levels,25,10,2.5,35
structural,12,mount,25,10,2.5,35
drive,12,2037,25,10,2.5,35
allspice,12,pomegranates,25,10,2.5,35
beets,12,93,25,10,2.5,35
herbal,911,blackberry,1440,579,2.487046632,2019
dark,295,opens,532,214,2.485981308,746
may,102,where,181,73,2.479452055,254
creamy,336,smoky,601,243,2.473251029,844
makes,173,offering,309,125,2.472,434
warm,134,flowers,237,96,2.46875,333
late,41,holds,79,32,2.46875,111
easily,19,rioja,37,15,2.466666667,52
nuances,16,brand,32,13,2.461538462,45
melted,49,part,93,38,2.447368421,131
between,49,keeps,93,38,2.447368421,131
elegant,47,lend,90,37,2.432432432,127
spain,17,alive,34,14,2.428571429,48
hot,325,tight,573,236,2.427966102,809
heavily,70,beyond,128,53,2.41509434,181
complex,42,oregano,82,34,2.411764706,116
effort,43,takes,84,35,2.4,119
challenging,18,mind,36,15,2.4,51
mars,18,dr.,36,15,2.4,51
ago,12,tantalizing,24,10,2.4,34
cigar,12,san,24,10,2.4,34
gamay,12,steep,24,10,2.4,34
abundance,12,biodynamic,24,10,2.4,34
road,12,acres,24,10,2.4,34
scented,12,wrap,24,10,2.4,34
correct,12,mixes,24,10,2.4,34
kool-aid,12,art,24,10,2.4,34
abrupt,12,well-crafted,24,10,2.4,34
deal,12,olallieberry,24,10,2.4,34
become,12,winemakers,24,10,2.4,34
flaws,12,hallmarks,24,10,2.4,34
chianti,12,lick,24,10,2.4,34
sit,12,beneath,24,10,2.4,34
atop,12,24,24,10,2.4,34
monterey,12,wow,24,10,2.4,34
somewhere,12,ripest,24,10,2.4,34
pencil,12,savoriness,24,10,2.4,34
scoury,12,damson,24,10,2.4,34
normal,12,light-footed,24,10,2.4,34
apparent,12,ner,24,10,2.4,34
2012,12,immaculate,24,10,2.4,34
green-fruit,12,deserves,24,10,2.4,34
la,12,dances,24,10,2.4,34
needed,12,tradition,24,10,2.4,34
excess,12,coat,24,10,2.4,34
lemongrass,12,counterpoint,24,10,2.4,34
creating,12,leap,24,10,2.4,34
heavier,12,endlessly,24,10,2.4,34
stemmy,89,'ll,158,66,2.393939394,224
lychee,113,open,203,85,2.388235294,288
saucy,55,effort,102,43,2.372093023,145
cleansing,27,60,52,22,2.363636364,74
takes,35,when,68,29,2.344827586,97
fleeting,42,under,82,35,2.342857143,117
sweaty,68,nicely,124,53,2.339622642,177
abrasive,36,enjoyable,70,30,2.333333333,100
results,24,evident,49,21,2.333333333,70
hide,18,straight,35,15,2.333333333,50
steam,14,spine,28,12,2.333333333,40
tobacco,185,cranberry,338,145,2.331034483,483
oregano,34,oil,65,28,2.321428571,93
we,45,lasting,88,38,2.315789474,126
plump,119,grilled,213,92,2.315217391,305
decidedly,19,filled,37,16,2.3125,53
mind,15,blackened,30,13,2.307692308,43
convincing,15,softened,30,13,2.307692308,43
minerals,15,edged,30,13,2.307692308,43
16,15,creaminess,30,13,2.307692308,43
sharp,453,wood,760,330,2.303030303,1090
hazelnut,12,boasting,23,10,2.3,33
streamlined,12,complement,23,10,2.3,33
reflects,12,developed,23,10,2.3,33
sets,12,tuscan,23,10,2.3,33
content,12,finally,23,10,2.3,33
recalls,12,austerity,23,10,2.3,33
entrance,12,longevity,23,10,2.3,33
stiff,12,reserve-level,23,10,2.3,33
bead,12,fore,23,10,2.3,33
brittle,12,darkly,23,10,2.3,33
dish,12,merest,23,10,2.3,33
minimal,12,small-production,23,10,2.3,33
wan,12,graham,23,10,2.3,33
spine,12,total,23,10,2.3,33
compromise,12,barbaresco,23,10,2.3,33
meld,12,sizzling,23,10,2.3,33
violets,12,utter,23,10,2.3,33
barbecued,12,elusive,23,10,2.3,33
bittersweet,12,build,23,10,2.3,33
there,1090,at,1604,698,2.297994269,2302
vintage,162,franc,294,128,2.296875,422
distinctly,28,extreme,55,24,2.291666667,79
cool,77,midpalate,142,62,2.290322581,204
sense,56,itself,103,45,2.288888889,148
own,41,opening,80,35,2.285714286,115
sugary,302,cola,538,236,2.279661017,774
hollow,74,being,139,61,2.278688525,200
moderate,30,lees,59,26,2.269230769,85
grating,35,them,68,30,2.266666667,98
tasty,27,includes,52,23,2.260869565,75
break,13,lending,27,12,2.25,39
pure,43,real,85,38,2.236842105,123
shearing,19,again,38,17,2.235294118,55
intriguing,19,custard,38,17,2.235294118,55
right,117,riesling,210,94,2.234042553,304
2016,30,pastry,58,26,2.230769231,84
coastal,15,80,29,13,2.230769231,42
forceful,15,combined,29,13,2.230769231,42
vibrancy,15,word,29,13,2.230769231,42
dill,24,dust,49,22,2.227272727,71
would,150,was,267,120,2.225,387
stalky,274,honey,476,215,2.213953488,691
crisp,850,shows,1328,601,2.209650582,1929
aggressive,57,strongly,106,48,2.208333333,154
quince,27,flavorful,53,24,2.208333333,77
suggestion,27,black-currant,53,24,2.208333333,77
lacks,224,show,394,179,2.201117318,573
country,18,waft,35,16,2.1875,51
ritif,58,golden,107,49,2.183673469,156
drink,1292,by,2272,1043,2.178331735,3315
streak,90,two,159,73,2.178082192,232
food,94,cool,167,77,2.168831169,244
rind,48,were,91,42,2.166666667,133
overwhelms,13,lemongrass,26,12,2.166666667,38
apart,13,2012,26,12,2.166666667,38
word,13,structural,26,12,2.166666667,38
mostly,98,touches,173,80,2.1625,253
create,35,form,67,31,2.161290323,98
compromised,21,think,41,19,2.157894737,60
muted,52,immediately,97,45,2.155555556,142
ripe,873,texture,1385,643,2.153965785,2028
j.c,14,tree,28,13,2.153846154,41
consistent,14,bark,28,13,2.153846154,41
variety,111,olive,200,93,2.150537634,293
perhaps,44,approachable,86,40,2.15,126
oily,164,mix,298,139,2.143884892,437
burning,15,organically,30,14,2.142857143,44
define,32,relatively,62,29,2.137931034,91
indistinct,16,16,32,15,2.133333333,47
mealy,118,they,213,100,2.13,313
barrels,26,whose,51,24,2.125,75
marked,66,given,121,57,2.122807018,178
okay,59,background,110,52,2.115384615,162
vegetables,28,50,57,27,2.111111111,84
peppery,201,blackberries,366,174,2.103448276,540
fiery,36,based,69,33,2.090909091,102
fermentation,24,backdrop,48,23,2.086956522,71
scents,199,),361,173,2.086705202,534
wines,121,tannin,217,104,2.086538462,321
volatility,25,cuts,50,24,2.083333333,74
continue,13,stuffing,25,12,2.083333333,37
losing,13,speak,25,12,2.083333333,37
green,1297,as,2378,1142,2.082311734,3520
masked,14,large,27,13,2.076923077,40
recommend,13,apart,27,13,2.076923077,40
soda-like,13,coating,27,13,2.076923077,40
currants,123,raspberries,218,105,2.076190476,323
foxy,45,honeysuckle,87,42,2.071428571,129
pair,195,(,358,173,2.069364162,531
california,48,region,91,44,2.068181818,135
dominating,33,completely,64,31,2.064516129,95
artificial,39,name,74,36,2.055555556,110
nero,23,ride,45,22,2.045454545,67
peanut,24,dill,49,24,2.041666667,73
viura,27,charm,53,26,2.038461538,79
cherry,1736,for,2810,1379,2.037708484,4189
vinho,28,unique,55,27,2.037037037,82
focus,29,shiraz,57,28,2.035714286,85
plum,833,more,1301,641,2.029641186,1942
aged,56,meaty,103,51,2.019607843,154
animal,61,dre,113,56,2.017857143,169
soften,65,months,119,59,2.016949153,178
better,119,rounded,213,106,2.009433962,319
oxidized,123,toasted,220,110,2,330
cream,80,accents,144,72,2,216
match,44,suggesting,86,43,2,129
muscat,26,half,52,26,2,78
steel,23,course,46,23,2,69
unripeness,23,steel,46,23,2,69
de,21,case,40,20,2,60
overt,18,conveys,36,18,2,54
running,18,dimension,36,18,2,54
sure,18,clay,36,18,2,54
seed,15,lusty,30,15,2,45
gluey,12,14,24,12,2,36
sunny,12,ed,24,12,2,36
strong,227,scents,396,199,1.989949749,595
fall,40,level,77,39,1.974358974,116
tomato,191,weight,355,180,1.972222222,535
oil,28,underneath,57,29,1.965517241,86
unique,27,aromatically,53,27,1.962962963,80
used,23,toffee,47,24,1.958333333,71
chunky,259,herbs,458,234,1.957264957,692
petite,97,cocoa,170,87,1.954022989,257
walnut,21,see,41,21,1.952380952,62
verdot,65,who,119,61,1.950819672,180
salmon,20,defined,39,20,1.95,59
a,12780,of,19178,9854,1.946214735,29032
while,1005,fruits,1570,809,1.940667491,2379
hits,31,appear,62,32,1.9375,94
hand,15,approach,29,15,1.933333333,44
inoffensive,14,look,29,15,1.933333333,44
impression,62,entirely,114,59,1.93220339,173
fruity,801,very,1289,668,1.929640719,1957
farmyard,14,rises,27,14,1.928571429,41
area,13,amid,25,13,1.923076923,38
seeming,12,undertones,23,12,1.916666667,35
bright,457,also,776,405,1.916049383,1181
fully,59,mourv,111,58,1.913793103,169
quaffer,21,burst,42,22,1.909090909,64
warmth,21,hinting,40,21,1.904761905,61
dog,19,pop,38,20,1.9,58
vitality,19,central,38,20,1.9,58
offering,125,better,226,119,1.899159664,345
narrow,83,honeyed,148,78,1.897435897,226
pinched,36,40,70,37,1.891891892,107
oranges,54,throughout,100,53,1.886792453,153
acidic,320,toast,567,301,1.88372093,868
mild,219,floral,389,208,1.870192308,597
s,118,giving,211,113,1.867256637,324
gris,28,shape,56,30,1.866666667,86
harshness,14,north,28,15,1.866666667,43
act,14,describe,28,15,1.866666667,43
sound,36,personality,69,37,1.864864865,106
",",28042,",",52084,28042,1.857356822,80126
pyrazinic,13,deliver,26,14,1.857142857,40
the,14268,the,26438,14268,1.852957668,40706
powerful,32,minerally,63,34,1.852941176,97
mint,190,mint,351,190,1.847368421,541
support,38,underlying,72,39,1.846153846,111
tan,12,acacia,24,13,1.846153846,37
merlot,355,spicy,611,332,1.840361446,943
funky,156,lively,288,157,1.834394904,445
oxidation,22,stand,44,24,1.833333333,68
sticky,126,zesty,226,124,1.822580645,350
addition,26,amounts,51,28,1.821428571,79
noticeable,25,quince,49,27,1.814814815,76
coming,41,bone,78,43,1.813953488,121
approach,15,red-cherry,29,16,1.8125,45
s.h,20,viscous,38,21,1.80952381,59
feeling,88,go,155,86,1.802325581,241
candied,508,be,895,497,1.800804829,1392
mangoes,14,2010,27,15,1.8,42
stuff,30,equally,59,33,1.787878788,92
pulpy,25,distinct,50,28,1.785714286,78
large,13,current,25,14,1.785714286,39
preserves,16,bone-dry,32,18,1.777777778,50
fat,58,never,108,61,1.770491803,169
rztraminer,23,initial,46,26,1.769230769,72
orange,488,bright,808,457,1.768052516,1265
in,4180,in,7387,4180,1.76722488,11567
coffee,136,dusty,240,137,1.751824818,377
chardonnay,489,lemon,823,470,1.75106383,1293
lean,470,just,786,449,1.750556793,1235
least,25,brightened,49,28,1.75,77
semisour,14,guava,28,16,1.75,44
spicy,332,made,593,339,1.749262537,932
asian,24,nut,47,27,1.740740741,74
part,38,goes,73,42,1.738095238,115
veering,13,hand,26,15,1.733333333,41
chewy,78,finishing,142,82,1.731707317,224
plenty,144,berries,258,149,1.731543624,407
last,28,nearly,57,33,1.727272727,90
cabernet,484,out,800,464,1.724137931,1264
great,99,really,174,101,1.722772277,275
jalape,32,tongue,62,36,1.722222222,98
casual,31,create,60,35,1.714285714,95
serviceable,12,tarragon,24,14,1.714285714,38
oaked,46,dryness,89,52,1.711538462,141
banana,167,grapes,299,175,1.708571429,474
can,137,plenty,245,144,1.701388889,389
it,5842,wine,9223,5426,1.699778843,14649
flavors,6506,it,9911,5842,1.696508045,15753
marred,20,70,39,23,1.695652174,62
ager,14,proper,27,16,1.6875,43
suit,19,wave,37,22,1.681818182,59
presents,19,surface,37,22,1.681818182,59
appeal,87,grenache,153,91,1.681318681,244
might,63,element,116,69,1.68115942,185
vegetable,24,jasmine,47,28,1.678571429,75
smooth,208,noir,374,223,1.677130045,597
itself,45,carries,87,52,1.673076923,139
screwcap,82,back,145,87,1.666666667,232
let,18,means,35,21,1.666666667,56
amid,13,vibrancy,25,15,1.666666667,40
other,132,bodied,236,142,1.661971831,378
burnt,264,hints,461,278,1.658273381,739
estate,32,reminiscent,63,38,1.657894737,101
start,60,brown,112,68,1.647058824,180
similar,43,blended,84,51,1.647058824,135
on,3813,to,6151,3744,1.642895299,9895
iodine,12,stems,23,14,1.642857143,37
italy,45,behind,87,53,1.641509434,140
vegetal,287,cherries,511,312,1.637820513,823
lift,41,rind,78,48,1.625,126
nicely,53,interesting,98,61,1.606557377,159
enough,256,come,447,279,1.602150538,726
flesh,24,field,48,30,1.6,78
aromas,3380,that,4751,2981,1.593760483,7732
soft,1589,cherry,2765,1736,1.592741935,4501
settles,18,gamy,35,22,1.590909091,57
cherries,312,currant,552,347,1.590778098,899
dryness,52,sauce,97,61,1.590163934,158
stems,14,softer,27,17,1.588235294,44
balance,279,along,488,308,1.584415584,796
leading,45,softly,87,55,1.581818182,142
features,59,bordeaux,109,69,1.579710145,178
black-fruit,37,simply,71,45,1.577777778,116
to,3744,'s,5788,3692,1.567713976,9480
already,63,something,116,74,1.567567568,190
shell,18,south,36,23,1.565217391,59
mixed,73,been,133,85,1.564705882,218
ashy,12,size,25,16,1.5625,41
keeps,38,far,73,47,1.553191489,120
scent,51,racy,96,62,1.548387097,158
exotic,53,butter,99,64,1.546875,163
is,7281,is,11250,7281,1.545117429,18531
toasty,108,despite,190,123,1.544715447,313
color,433,you,732,477,1.534591195,1209
with,9360,this,12009,7827,1.534304331,19836
showing,178,gives,325,213,1.525821596,538
semi-sweet,18,pleasantly,35,23,1.52173913,58
lifted,18,touched,35,23,1.52173913,58
fried,18,juiciness,35,23,1.52173913,58
sturdy,24,southern,47,31,1.516129032,78
certainly,32,amount,62,41,1.512195122,103
instead,32,late,62,41,1.512195122,103
underlying,39,because,74,49,1.510204082,123
toasted,110,other,199,132,1.507575758,331
satisfy,26,bread,51,34,1.5,85
violet,22,rise,42,28,1.5,70
port-like,21,whiffs,42,28,1.5,70
suggestive,21,prominent,42,28,1.5,70
picture,13,contains,27,18,1.5,45
you,477,offers,796,531,1.49905838,1327
has,2013,acidity,3266,2181,1.497478221,5447
muddled,71,set,131,88,1.488636364,219
grapefruit,246,syrah,436,293,1.488054608,729
short,342,sauvignon,602,406,1.482758621,1008
tropical,331,which,593,400,1.4825,993
varieties,62,forward,114,77,1.480519481,191
quick,61,spiced,112,76,1.473684211,188
tinge,14,traditional,28,19,1.473684211,47
strange,91,cut,162,110,1.472727273,272
chalky,71,your,128,87,1.471264368,215
.,25776,and,36052,24613,1.464754398,60665
honeyed,78,find,142,97,1.463917526,239
drinking,123,tones,221,151,1.463576159,372
bubbly,41,mushroom,79,54,1.462962963,133
keep,62,fleshy,114,78,1.461538462,192
accent,48,final,92,63,1.46031746,155
fruit,3045,fruit,4444,3045,1.459441708,7489
overtly,46,likely,89,61,1.459016393,150
chocolate,369,pinot,638,438,1.456621005,1076
side,233,style,402,276,1.456521739,678
natural,53,drinkable,99,68,1.455882353,167
seemingly,41,whole,80,55,1.454545455,135
edgy,88,wet,157,108,1.453703704,265
spritzy,45,start,87,60,1.45,147
your,87,those,155,107,1.448598131,262
properly,20,becomes,39,27,1.444444444,66
celery,24,nuts,49,34,1.441176471,83
perfume,30,tang,59,41,1.43902439,100
much,626,white,988,687,1.438136827,1675
feed,12,zippy,23,16,1.4375,39
toward,93,varietal,165,115,1.434782609,280
hard-edged,17,punch,33,23,1.434782609,56
juicy,315,pear,558,389,1.434447301,947
prickle,26,asphalt,50,35,1.428571429,85
case,20,overtones,40,28,1.428571429,68
even,155,although,284,199,1.427135678,483
simple,1212,an,2029,1428,1.420868347,3457
watermelon,35,accent,68,48,1.416666667,116
job,34,edges,65,46,1.413043478,111
pairing,24,interest,48,34,1.411764706,82
marks,32,perhaps,62,44,1.409090909,106
pickled,119,malbec,214,153,1.39869281,367
influence,27,chocolaty,53,38,1.394736842,91
confected,53,suggests,99,71,1.394366197,170
subdued,44,impression,86,62,1.387096774,148
call,22,touriga,43,31,1.387096774,74
aroma,194,apricot,356,257,1.385214008,613
keeping,18,molasses,36,26,1.384615385,62
smelling,175,strong,314,227,1.383259912,541
top,53,chalky,98,71,1.38028169,169
of,9854,a,17635,12780,1.379890454,30415
m.m,16,results,33,24,1.375,57
and,24613,.,35356,25776,1.371663563,61132
are,2237,palate,3599,2654,1.356066315,6253
accessible,22,softness,42,31,1.35483871,73
cracker,21,characteristics,42,31,1.35483871,73
airing,46,soften,88,65,1.353846154,153
vanilla,699,fresh,1164,861,1.351916376,2025
somewhat,211,here,381,283,1.346289753,664
closes,18,addition,35,26,1.346153846,61
lambrusco,20,county,39,29,1.344827586,68
citrus,960,oak,1516,1128,1.343971631,2644
struggle,22,marks,43,32,1.34375,75
label,45,backed,88,66,1.333333333,154
higher,35,especially,68,51,1.333333333,119
had,22,powder,44,33,1.333333333,77
rises,14,ending,28,21,1.333333333,49
brambly,57,sangiovese,106,80,1.325,186
leaves,79,apples,143,108,1.324074074,251
different,23,highly,45,34,1.323529412,79
reserve,21,shy,41,31,1.322580645,72
very,668,plum,1099,833,1.319327731,1932
papaya,106,fruitiness,189,144,1.3125,333
filling,43,apricots,84,64,1.3125,148
reveal,20,nacional,38,29,1.310344828,67
zinfandel,128,about,234,179,1.30726257,413
entirely,59,making,111,85,1.305882353,196
n't,636,raspberry,1004,771,1.302204929,1775
unusual,90,drinking,160,123,1.300813008,283
points,20,stuff,39,30,1.3,69
lacking,108,could,191,148,1.290540541,339
cheerful,21,nature,40,31,1.290322581,71
finishing,82,across,145,113,1.283185841,258
recall,35,natural,68,53,1.283018868,121
packed,42,pears,82,64,1.28125,146
satisfying,12,medium-sweet,23,18,1.277777778,41
level,39,fat,74,58,1.275862069,132
buttered,167,make,299,236,1.266949153,535
summer,62,streak,114,90,1.266666667,204
blow,19,lighter,38,30,1.266666667,68
turns,158,caramel,290,230,1.260869565,520
greenness,15,used,29,23,1.260869565,52
previous,15,found,29,23,1.260869565,52
including,17,spring,34,27,1.259259259,61
bottles,20,weighty,39,31,1.258064516,70
by,1043,notes,1597,1272,1.255503145,2869
$,39,features,74,59,1.254237288,133
(,173,grapefruit,308,246,1.25203252,554
pomegranate,18,shot,35,28,1.25,63
consumed,13,heft,25,20,1.25,45
underwhelming,12,tannat,25,20,1.25,45
shiraz,28,leading,56,45,1.244444444,101
greater,16,sweetly,31,25,1.24,56
generic,229,hint,398,321,1.239875389,719
vague,13,appearance,26,21,1.238095238,47
blowsy,13,characterize,26,21,1.238095238,47
stone,119,makes,214,173,1.23699422,387
shows,601,blend,983,795,1.236477987,1778
roasted,186,;,346,280,1.235714286,626
fleshy,78,refreshing,142,115,1.234782609,257
salty,145,then,264,214,1.23364486,478
combines,19,moderate,37,30,1.233333333,67
sandalwood,19,superripe,37,30,1.233333333,67
quiet,16,framing,32,26,1.230769231,58
old,73,variety,136,111,1.225225225,247
each,17,extract,33,27,1.222222222,60
know,23,gold,45,37,1.216216216,82
rather,244,merlot,431,355,1.214084507,786
give,250,almost,440,364,1.208791209,804
likeable,15,signs,29,24,1.208333333,53
this,7827,with,11275,9360,1.204594017,20635
classic,34,bring,65,54,1.203703704,119
malbec,153,only,279,232,1.202586207,511
acceptable,51,cream,96,80,1.2,176
verde,28,strawberries,54,45,1.2,99
exhibits,12,ripened,24,20,1.2,44
full-bodied,134,quality,237,198,1.196969697,435
cheesy,41,bean,79,66,1.196969697,145
lemons,35,result,67,56,1.196428571,123
brings,91,warm,160,134,1.194029851,294
mango,120,do,217,182,1.192307692,399
acidity,2181,but,3392,2848,1.191011236,6240
bearing,13,characteristic,26,22,1.181818182,48
few,86,though,151,128,1.1796875,279
fade,23,try,46,39,1.179487179,85
lamb,21,kick,40,34,1.176470588,74
re,32,plus,62,53,1.169811321,115
lends,14,spent,28,24,1.166666667,52
bland,158,baked,291,250,1.164,541
grippy,25,filling,50,43,1.162790698,93
like,1037,red,1594,1380,1.155072464,2974
softness,31,drinks,60,52,1.153846154,112
generous,40,marked,76,66,1.151515152,142
about,179,lead,327,284,1.151408451,611
hearty,16,influence,31,27,1.148148148,58
reasonably,28,hit,55,48,1.145833333,103
earthy,481,vanilla,800,699,1.144492132,1499
at,698,while,1149,1005,1.143283582,2154
wintergreen,16,plummy,32,28,1.142857143,60
older,12,saline,24,21,1.142857143,45
date,12,cracker,24,21,1.142857143,45
aging,127,what,227,199,1.140703518,426
solid,119,thick,213,187,1.139037433,400
into,313,orange,555,488,1.137295082,1043
high-acid,29,scent,58,51,1.137254902,109
creamed,17,appears,34,30,1.133333333,64
floral,208,creamy,380,336,1.130952381,716
brand,13,pronounced,26,23,1.130434783,49
any,118,roasted,210,186,1.129032258,396
notes,1272,has,2272,2013,1.128663686,4285
final,63,skin,115,102,1.12745098,217
that,2981,on,4298,3813,1.127196433,8111
foamy,53,austere,99,88,1.125,187
further,14,pairing,27,24,1.125,51
follow,38,away,73,65,1.123076923,138
combination,33,appealing,64,57,1.122807018,121
based,33,brambly,64,57,1.122807018,121
leave,33,astringency,64,57,1.122807018,121
almost,364,up,633,564,1.122340426,1197
bath,19,remain,37,33,1.121212121,70
raspberry,771,there,1212,1090,1.111926606,2302
raspy,15,suggestion,30,27,1.111111111,57
hit,48,rhubarb,91,82,1.109756098,173
some,1020,nose,1583,1431,1.106219427,3014
pear,389,touch,647,588,1.100340136,1235
traces,12,successful,24,22,1.090909091,46
spectrum,12,call,24,22,1.090909091,46
fur,19,early,37,34,1.088235294,71
particular,19,runs,37,34,1.088235294,71
moderately,20,limes,38,35,1.085714286,73
tannins,1306,are,2428,2237,1.085382208,4665
unconvincing,13,sturdy,26,24,1.083333333,50
lime,285,note,508,470,1.080851064,978
earth,151,way,275,255,1.078431373,530
sipper,29,run,57,53,1.075471698,110
glass,72,pie,133,124,1.072580645,257
residual,86,lots,151,141,1.070921986,292
run,53,charred,98,92,1.065217391,190
fair,25,port,49,46,1.065217391,95
prominent,28,drunk,56,53,1.056603774,109
comes,168,lime,300,285,1.052631579,585
goes,42,leaves,83,79,1.050632911,162
perfect,23,meats,45,43,1.046511628,88
lending,12,had,23,22,1.045454545,45
cuts,24,label,47,45,1.044444444,92
green-herb,13,northern,25,24,1.041666667,49
tarragon,14,particularly,27,26,1.038461538,53
young,139,body,245,237,1.033755274,482
peel,90,without,160,155,1.032258065,315
again,17,blast,34,33,1.03030303,67
how,21,maybe,41,40,1.025,81
sb,28,typical,55,54,1.018518519,109
develop,28,caramelized,55,54,1.018518519,109
shy,31,char,60,59,1.016949153,119
delicious,37,syrup,71,70,1.014285714,141
cider,42,milk,82,81,1.012345679,163
than,414,character,726,718,1.011142061,1444
grigio,65,any,119,118,1.008474576,237
same,62,close,114,114,1,228
soil,15,component,31,31,1,62
yeasty,128,tangy,234,236,0.991525424,470
layers,41,extracted,78,79,0.987341772,157
leathery,123,if,219,222,0.986486486,441
tempranillo,72,down,133,135,0.985185185,268
weedy,109,peppery,197,201,0.980099502,398
place,21,air,40,41,0.975609756,81
include,61,brisk,112,115,0.973913043,227
lasting,38,broad,72,74,0.972972973,146
severe,18,version,35,36,0.972222222,71
component,31,varieties,60,62,0.967741935,122
dull,183,strawberry,335,348,0.962643678,683
grape,176,ready,317,330,0.960606061,647
fish,22,italy,43,45,0.955555556,88
experience,21,extraction,41,43,0.953488372,84
potential,21,expect,40,42,0.952380952,82
find,97,almond,171,180,0.95,351
good,707,berry,1185,1251,0.947242206,2436
normally,17,lemon-lime,34,36,0.944444444,70
enjoyment,17,follows,34,36,0.944444444,70
albari,16,lemons,33,35,0.942857143,68
foods,34,dominated,65,69,0.942028986,134
course,23,work,45,48,0.9375,93
syrah,293,peach,518,554,0.935018051,1072
price,218,than,387,414,0.934782609,801
years,92,followed,163,176,0.926136364,339
have,312,tannic,545,589,0.925297114,1134
wood,330,or,590,639,0.923317684,1229
paste,12,brut,24,26,0.923076923,50
terribly,24,'re,47,51,0.921568627,98
yeast,29,might,58,63,0.920634921,121
harsh,155,have,285,312,0.913461538,597
table,49,gentle,94,103,0.912621359,197
scour,20,soon,38,42,0.904761905,80
northern,24,flavored,47,52,0.903846154,99
millon,23,tartness,46,51,0.901960784,97
tones,151,edge,274,304,0.901315789,578
loud,18,drop,35,39,0.897435897,74
entry-level,13,fact,26,29,0.896551724,55
root,17,rest,34,38,0.894736842,72
ruby,21,tone,42,47,0.893617021,89
unripe,109,end,193,216,0.893518519,409
issues,15,middle,31,35,0.885714286,66
freshener,22,rh,43,49,0.87755102,92
cinsault,14,sensations,28,32,0.875,60
focused,14,re,28,32,0.875,60
blocky,35,skins,68,78,0.871794872,146
totally,27,include,53,61,0.868852459,114
tight,236,earthy,417,481,0.866943867,898
closed,33,offer,64,74,0.864864865,138
parties,41,sirah,78,91,0.857142857,169
youth,12,hardly,24,28,0.857142857,52
bitter,700,dry,1185,1388,0.853746398,2573
contains,18,due,35,41,0.853658537,76
expect,42,petite,82,97,0.845360825,179
loads,16,follow,32,38,0.842105263,70
perfectly,19,subdued,37,44,0.840909091,81
forced,53,mango,100,120,0.833333333,220
charred,92,round,164,197,0.83248731,361
cocoa,87,bouquet,154,185,0.832432432,339
behind,53,plump,99,119,0.831932773,218
leftover,15,say,29,35,0.828571429,64
many,75,cab,140,169,0.828402367,309
passion,43,may,84,102,0.823529412,186
layering,12,gris,23,28,0.821428571,51
produces,12,qualities,23,28,0.821428571,51
result,56,lemony,104,127,0.818897638,231
toast,301,flavor,538,657,0.818873668,1195
heart,14,colored,27,33,0.818181818,60
within,15,ends,30,37,0.810810811,67
marshmallow,21,dominates,41,51,0.803921569,92
sulfuric,23,probably,47,59,0.796610169,106
problem,20,table,39,49,0.795918367,88
woody,119,off,214,269,0.795539033,483
crisply,12,ne,23,29,0.793103448,52
expressive,23,terms,45,57,0.789473684,102
neither,25,crispness,50,64,0.78125,114
gives,213,chardonnay,381,489,0.779141104,870
chard,71,buttered,130,167,0.778443114,297
ever,14,prime,28,36,0.777777778,64
them,30,gets,59,76,0.776315789,135
which,400,crisp,655,850,0.770588235,1505
nacional,29,however,57,74,0.77027027,131
also,405,apple,702,914,0.768052516,1616
dry,1388,aromas,2584,3380,0.764497041,5964
jagged,29,point,58,76,0.763157895,134
o,73,grape,134,176,0.761363636,310
smoke,111,quite,200,264,0.757575758,464
orchard,13,leave,25,33,0.757575758,58
show,179,color,327,433,0.755196305,760
sauvignon,406,citrus,720,960,0.75,1680
cement,16,match,33,44,0.75,77
wrong,15,gently,30,40,0.75,70
sea,16,passion,32,43,0.744186047,75
cloying,136,sweetness,241,324,0.74382716,565
for,1379,finish,2441,3286,0.742848448,5727
drop,39,dessert,75,101,0.742574257,176
ruby-colored,12,american,23,31,0.741935484,54
priced,22,onto,43,58,0.74137931,101
wave,22,bite,43,58,0.74137931,101
defined,20,surprisingly,39,53,0.735849057,92
appellation,32,residual,63,86,0.73255814,149
cellar,15,seemingly,30,41,0.731707317,71
gummy,33,mark,65,89,0.730337079,154
bring,54,going,102,140,0.728571429,242
their,37,viognier,72,99,0.727272727,171
espresso,24,leads,48,66,0.727272727,114
possible,16,tasted,32,44,0.727272727,76
leather,193,mouthfeel,356,490,0.726530612,846
powdery,27,o,53,73,0.726027397,126
rare,13,definitely,26,36,0.722222222,62
middle,35,peaches,67,93,0.720430108,160
vibrant,36,nectarine,69,96,0.71875,165
foam,12,instead,23,32,0.71875,55
combined,13,honeydew,25,35,0.714285714,60
balances,13,recall,25,35,0.714285714,60
overwhelm,12,upfront,25,35,0.714285714,60
either,23,things,47,66,0.712121212,113
far,47,yeasty,91,128,0.7109375,219
undertones,12,wide,24,34,0.705882353,58
basic,254,mouth,441,626,0.704472843,1067
marginal,16,value,33,47,0.70212766,80
finish,3286,flavors,4557,6506,0.700430372,11063
corn,56,would,105,150,0.7,255
generally,15,bramble,31,45,0.688888889,76
underneath,29,leaving,57,83,0.686746988,140
almonds,13,offset,26,38,0.684210526,64
nutmeg,15,briary,30,44,0.681818182,74
complexity,85,acids,150,221,0.678733032,371
colored,33,carry,65,96,0.677083333,161
beautiful,14,jelly,27,40,0.675,67
before,97,enough,172,256,0.671875,428
tasting,144,pineapple,264,395,0.66835443,659
barrel,87,aftertaste,154,232,0.663793103,386
flower,103,jam,184,278,0.661870504,462
concentration,99,no,174,264,0.659090909,438
golden,49,prune,92,140,0.657142857,232
citric,131,high,235,358,0.656424581,593
bacon,48,suggest,91,139,0.654676259,230
spoils,14,use,28,43,0.651162791,71
quite,264,good,459,707,0.649222065,1166
marmalade,19,dominant,37,57,0.649122807,94
plus,53,get,99,154,0.642857143,253
custard,17,help,34,53,0.641509434,87
topped,12,carob,23,36,0.638888889,59
cough,38,dominate,74,117,0.632478632,191
varietal,115,tropical,206,331,0.622356495,537
extraction,43,front,84,135,0.622222222,219
value,47,salty,90,145,0.620689655,235
fact,29,toward,57,93,0.612903226,150
funk,22,nutty,44,72,0.611111111,116
scattered,15,pungent,31,51,0.607843137,82
nutty,72,juice,133,220,0.604545455,353
over,228,tart,397,667,0.595202399,1064
nectarine,96,pretty,168,284,0.591549296,452
these,28,buttery,55,93,0.591397849,148
overdone,18,kind,36,61,0.590163934,97
ed,12,similar,25,43,0.581395349,68
enjoyable,30,slight,59,102,0.578431373,161
stuffing,12,soda,23,40,0.575,63
indicates,14,cooked,27,47,0.574468085,74
against,20,past,39,68,0.573529412,107
touriga,31,butterscotch,60,105,0.571428571,165
something,74,sugar,138,244,0.56557377,382
taste,327,some,575,1020,0.56372549,1595
prune,140,does,251,452,0.555309735,703
range,19,drying,38,69,0.550724638,107
plush,21,mixed,40,73,0.547945205,113
manages,12,bubbles,23,42,0.547619048,65
or,639,sweet,1011,1852,0.545896328,2863
gently,40,lot,75,138,0.543478261,213
name,36,profile,69,127,0.543307087,196
past,68,side,125,233,0.536480687,358
spiced,76,lightly,142,266,0.533834586,408
shot,28,less,56,105,0.533333333,161
black-currant,24,quickly,47,89,0.528089888,136
profile,127,hard,230,441,0.52154195,671
home,13,difficult,26,50,0.52,76
almond,180,n't,330,636,0.518867925,966
deliver,14,oranges,28,54,0.518518519,82
strawberry,348,not,608,1179,0.515691264,1787
charming,13,rugged,26,51,0.509803922,77
pleasantly,23,appeal,44,87,0.505747126,131
close,114,alcohol,205,407,0.503685504,612
want,28,starts,55,110,0.5,165
current,14,cheese,28,56,0.5,84
hue,12,direct,24,48,0.5,72
pie,124,clean,224,449,0.498886414,673
'd,23,food,46,94,0.489361702,140
beyond,53,overall,99,203,0.487684729,302
imported,39,raisin,75,155,0.483870968,230
describe,15,summer,30,62,0.483870968,92
entry,14,hay,28,58,0.482758621,86
clipped,30,leathery,59,123,0.479674797,182
pleasant,215,fruity,383,801,0.47815231,1184
missing,49,aroma,92,194,0.474226804,286
usa,17,tempranillo,34,72,0.472222222,106
just,449,soft,749,1589,0.471365639,2338
leesy,28,pink,56,119,0.470588235,175
jam,278,like,481,1037,0.463837994,1518
making,85,taste,150,327,0.458715596,477
however,74,seems,139,310,0.448387097,449
buried,13,sparkler,26,58,0.448275862,84
viognier,99,finishes,175,392,0.446428571,567
amounts,28,zinfandel,56,128,0.4375,184
grown,26,s,51,118,0.43220339,169
quaff,25,woody,50,119,0.420168067,169
loaded,20,nothing,39,93,0.419354839,132
trying,14,resin,27,65,0.415384615,92
falls,50,medium,94,227,0.414096916,321
lead,284,light,504,1244,0.405144695,1748
vines,21,sparkling,40,99,0.404040404,139
oak-based,18,red-berry,35,88,0.397727273,123
overtones,28,heat,55,140,0.392857143,195
need,37,nice,71,182,0.39010989,253
work,48,blanc,91,235,0.387234043,326
produce,17,pineapples,33,87,0.379310345,120
core,107,too,190,504,0.376984127,694
though,128,much,232,626,0.370607029,858
filled,16,unusual,33,90,0.366666667,123
deeply,15,screwcap,30,82,0.365853659,112
linear,16,feeling,32,88,0.363636364,120
chilean,19,neutral,37,102,0.362745098,139
garnacha,46,rather,88,244,0.360655738,332
chicken,36,pair,69,195,0.353846154,264
floor,19,acid,37,105,0.352380952,142
butterscotch,105,feel,186,532,0.34962406,718
largely,19,papaya,37,106,0.349056604,143
awkward,97,candied,171,508,0.336614173,679
box,18,barely,35,104,0.336538462,139
forest,38,price,73,218,0.334862385,291
ap,58,oaky,107,322,0.332298137,429
fizzy,18,stewed,36,112,0.321428571,148
bready,27,seem,52,168,0.30952381,220
rubbery,230,green,400,1297,0.308404009,1697
25,15,mostly,30,98,0.306122449,128
proper,16,turn,33,109,0.302752294,142
cava,21,citrusy,42,139,0.302158273,181
except,39,attractive,75,273,0.274725275,348
probably,59,jammy,110,402,0.273631841,512
faded,13,overly,27,100,0.27,127
wine,5426,?,7505,85,88.29411765,7590
nondescript,23,low,46,177,0.259887006,223
malvasia,16,zin,32,125,0.256,157
fermented,24,tomato,48,191,0.251308901,239
really,101,bit,179,714,0.25070028,893
successful,22,medium-bodied,44,177,0.248587571,221
supple,30,raw,58,236,0.245762712,294
max,13,otherwise,26,106,0.245283019,132
nor,24,minty,48,196,0.244897959,244
longer,24,tough,48,201,0.23880597,249
bordeaux-style,14,syrupy,28,118,0.237288136,146
lingers,28,candy,55,234,0.235042735,289
beet,14,underripe,27,116,0.232758621,143
dominate,117,herbal,209,911,0.229418222,1120
leaving,83,slightly,147,673,0.218424963,820
available,14,citric,28,131,0.213740458,159
most,81,little,145,685,0.211678832,830
looks,13,fairly,26,125,0.208,151
extracted,79,bitter,143,700,0.204285714,843
murky,84,feels,149,739,0.201623816,888
2010,15,tasting,29,144,0.201388889,173
liqueur,18,astringent,35,174,0.201149425,209
wiry,45,melon,87,440,0.197727273,527
valpolicella,15,funky,30,156,0.192307692,186
soapy,53,heavy,99,522,0.189655172,621
precede,29,acidic,58,320,0.18125,378
pine,28,hot,55,325,0.169230769,380
depth,77,tastes,142,858,0.165501166,1000
dash,18,pleasant,35,215,0.162790698,250
ginger,18,somewhat,34,211,0.161137441,245
offputting,12,turns,25,158,0.158227848,183
inky,16,bitterness,32,208,0.153846154,240
worth,20,burnt,39,264,0.147727273,303
beans,34,sour,66,455,0.145054945,521
lettuce,18,chunky,36,259,0.138996139,295
aromatically,27,easy,54,401,0.134663342,455
qualities,28,sharp,56,453,0.123620309,509
lusty,15,ros,29,272,0.106617647,301
lightest,20,smells,39,382,0.102094241,421
tawny,15,rustic,31,345,0.089855072,376
thrown,20,lean,39,470,0.082978723,509