Word_low,Frequency on Low-point descriptions,Word_high,Frequency,Frequency on High-point descriptions,low/high,total
simple,1212,an,2029,20,60.6,1232
thin,435,over,735,20,21.75,455
flat,357,wild,626,20,17.85,377
short,342,sauvignon,602,20,17.1,362
sugary,302,cola,538,20,15.1,322
vegetal,287,cherries,511,20,14.35,307
stalky,274,honey,476,20,13.7,294
basic,254,mouth,441,20,12.7,274
lean,470,just,786,39,12.05128205,509
rubbery,230,green,400,20,11.5,250
generic,229,hint,398,20,11.45,249
overripe,228,needs,397,20,11.4,248
lacks,224,show,394,20,11.2,244
rustic,345,clove,605,31,11.12903226,376
mild,219,floral,389,20,10.95,239
modest,217,opulent,386,20,10.85,237
smells,382,complexity,646,39,9.794871795,421
everyday,192,packed,356,20,9.6,212
rough,188,vines,349,20,9.4,208
ros,272,pure,473,29,9.379310345,301
briny,185,right,340,20,9.25,205
pithy,183,together,337,20,9.15,203
dull,183,strawberry,335,20,9.15,203
decent,177,mature,321,20,8.85,197
smelling,175,strong,314,20,8.75,195
grassy,175,classic,313,20,8.75,195
banana,167,grapes,299,20,8.35,187
oily,164,mix,298,20,8.2,184
sharp,453,wood,760,56,8.089285714,509
medicinal,158,until,294,20,7.9,178
watery,158,tea,292,20,7.9,178
bland,158,baked,291,20,7.9,178
harsh,155,have,285,20,7.75,175
resiny,153,around,279,20,7.65,173
easy,401,power,676,54,7.425925926,455
gritty,148,winemaker,265,20,7.4,168
leafy,144,aged,263,20,7.2,164
chunky,259,herbs,458,36,7.194444444,295
raisiny,140,produced,251,20,7,160
sour,455,richness,770,66,6.893939394,521
cloying,136,sweetness,241,20,6.8,156
dilute,136,brings,241,20,6.8,156
burnt,264,hints,461,39,6.769230769,303
bitterness,208,intensity,375,32,6.5,240
rubber,127,french,231,20,6.35,147
turns,158,caramel,290,25,6.32,183
sticky,126,zesty,226,20,6.3,146
off-dry,125,expression,225,20,6.25,145
somewhat,211,here,381,34,6.205882353,245
grabby,124,sage,224,20,6.2,144
oxidized,123,toasted,220,20,6.15,143
pleasant,215,fruity,383,35,6.142857143,250
tastes,858,firm,1343,142,6.042253521,1000
pickled,119,malbec,214,20,5.95,139
hot,325,tight,573,55,5.909090909,380
mealy,118,they,213,20,5.9,138
red-fruit,117,elements,209,20,5.85,137
lychee,113,open,203,20,5.65,133
acidic,320,toast,567,58,5.517241379,378
weedy,109,peppery,197,20,5.45,129
unripe,109,end,193,20,5.45,129
mildly,108,site,192,20,5.4,128
lacking,108,could,191,20,5.4,128
scratchy,106,floor,188,20,5.3,126
straightforward,106,decade,187,20,5.3,126
heavy,522,dried,898,99,5.272727273,621
funky,156,lively,288,30,5.2,186
lack,102,plush,183,20,5.1,122
melon,440,balance,740,87,5.057471264,527
herbaceous,100,take,177,20,5,120
astringent,174,refined,309,35,4.971428571,209
tasting,144,pineapple,264,29,4.965517241,173
feels,739,great,1208,149,4.959731544,888
bitter,700,dry,1185,143,4.895104895,843
awkward,97,candied,171,20,4.85,117
fairly,125,thyme,224,26,4.807692308,151
odd,95,fully,168,20,4.75,115
little,685,long,1109,145,4.724137931,830
citric,131,high,235,28,4.678571429,159
flabby,92,family,164,20,4.6,112
slightly,673,complex,1106,147,4.578231293,820
strange,91,cut,162,20,4.55,111
bell,90,blossom,159,20,4.5,110
raisins,89,lift,159,20,4.45,109
stemmy,89,'ll,158,20,4.45,109
edgy,88,wet,157,20,4.4,108
bad,88,against,155,20,4.4,108
herbal,911,blackberry,1440,209,4.358851675,1120
choppy,86,beef,151,20,4.3,106
barnyard,86,add,151,20,4.3,106
underripe,116,finesse,209,27,4.296296296,143
candy,234,barrel,407,55,4.254545455,289
syrupy,118,5,210,28,4.214285714,146
murky,84,feels,149,20,4.2,104
asparagus,84,stage,148,20,4.2,104
tough,201,exotic,369,48,4.1875,249
narrow,83,honeyed,148,20,4.15,103
grass,83,perfectly,147,20,4.15,103
minty,196,many,358,48,4.083333333,244
otherwise,106,backbone,187,26,4.076923077,132
raw,236,bottle,428,58,4.068965517,294
medium-bodied,177,violet,321,44,4.022727273,221
bit,714,all,1191,179,3.988826816,893
tomato,191,weight,355,48,3.979166667,239
zin,125,2030,226,32,3.90625,157
low,177,toasty,321,46,3.847826087,223
stewy,76,barolo,141,20,3.8,96
popcorn,75,2019,140,20,3.75,95
overly,100,intensely,176,27,3.703703704,127
hollow,74,being,139,20,3.7,94
jammy,402,smooth,686,110,3.654545455,512
unbalanced,73,massive,137,20,3.65,93
snappy,73,truffle,133,20,3.65,93
light-bodied,73,4,133,20,3.65,93
attractive,273,beautifully,476,75,3.64,348
angular,72,15,132,20,3.6,92
easygoing,72,chopped,131,20,3.6,92
muddled,71,set,131,20,3.55,91
diluted,71,beauty,130,20,3.55,91
one-dimensional,71,mouthwatering,130,20,3.55,91
chard,71,buttered,130,20,3.55,91
heavily,70,beyond,128,20,3.5,90
lightweight,69,support,126,20,3.45,89
sweaty,68,nicely,124,20,3.4,88
melony,67,combine,124,20,3.35,87
waxy,67,bacon,123,20,3.35,87
fare,67,minerals,122,20,3.35,87
citrusy,139,whiff,247,42,3.30952381,181
turn,109,chewy,195,33,3.303030303,142
mostly,98,touches,173,30,3.266666667,128
disjointed,65,asian,119,20,3.25,85
grigio,65,any,119,20,3.25,85
easy-drinking,65,coming,118,20,3.25,85
green,1297,as,2378,400,3.2425,1697
seem,168,100,300,52,3.230769231,220
canned,64,frame,118,20,3.2,84
faint,63,play,116,20,3.15,83
stewed,112,napa,201,36,3.111111111,148
porty,62,release,115,20,3.1,82
barbecue,62,petal,114,20,3.1,82
animal,61,dre,113,20,3.05,81
quick,61,spiced,112,20,3.05,81
oaky,322,core,568,107,3.009345794,429
standard,60,considerable,112,20,3,80
price,218,than,387,73,2.98630137,291
barely,104,perfect,185,35,2.971428571,139
candied,508,be,895,171,2.970760234,679
gooseberry,59,three,111,20,2.95,79
okay,59,background,110,20,2.95,79
dishes,59,fennel,109,20,2.95,79
clumsy,58,own,109,20,2.9,78
ap,58,oaky,107,20,2.9,78
ritif,58,golden,107,20,2.9,78
papaya,106,fruitiness,189,37,2.864864865,143
feel,532,one,908,186,2.860215054,718
tired,57,each,107,20,2.85,77
pale,57,champagne,107,20,2.85,77
aggressive,57,strongly,106,20,2.85,77
friendly,57,meet,105,20,2.85,77
prickly,57,3,105,20,2.85,77
informal,57,closed,105,20,2.85,77
acid,105,stunning,185,37,2.837837838,142
pair,195,(,358,69,2.826086957,264
corn,56,would,105,20,2.8,76
pizza,56,everything,103,20,2.8,76
rather,244,merlot,431,88,2.772727273,332
neutral,102,fine-grained,183,37,2.756756757,139
feeling,88,go,155,32,2.75,120
else,55,every,103,20,2.75,75
saucy,55,effort,102,20,2.75,75
screwcap,82,back,145,30,2.733333333,112
unusual,90,drinking,160,33,2.727272727,123
white-fruit,54,grip,102,20,2.7,74
compost,54,grippy,100,20,2.7,74
burgers,54,energy,100,20,2.7,74
much,626,white,988,232,2.698275862,858
too,504,elegant,864,190,2.652631579,694
forced,53,mango,100,20,2.65,73
soapy,53,heavy,99,20,2.65,73
foamy,53,austere,99,20,2.65,73
confected,53,suggests,99,20,2.65,73
pineapples,87,boysenberry,153,33,2.636363636,120
muted,52,immediately,97,20,2.6,72
blanc,235,2018,417,91,2.582417582,326
nice,182,currants,335,71,2.563380282,253
acceptable,51,cream,96,20,2.55,71
heat,140,hold,251,55,2.545454545,195
red-berry,88,last,155,35,2.514285714,123
soupy,50,satisfying,94,20,2.5,70
falls,50,medium,94,20,2.5,70
sort,50,liqueur,94,20,2.5,70
sparkling,99,their,173,40,2.475,139
light,1244,spice,2069,504,2.468253968,1748
regular,49,block,93,20,2.45,69
limited,49,2023,93,20,2.45,69
melted,49,part,93,20,2.45,69
jumpy,49,bracing,93,20,2.45,69
volatile,49,premier,93,20,2.45,69
plastic,49,sheer,93,20,2.45,69
burn,49,once,92,20,2.45,69
fun,49,rosemary,92,20,2.45,69
missing,49,aroma,92,20,2.45,69
medium,227,elegance,395,94,2.414893617,321
resin,65,8,119,27,2.407407407,92
weak,48,stylish,92,20,2.4,68
veer,48,robust,91,20,2.4,68
nothing,93,firmly,166,39,2.384615385,132
woody,119,off,214,50,2.38,169
reduced,47,2024,90,20,2.35,67
smell,47,dramatic,90,20,2.35,67
chemical,47,maturity,90,20,2.35,67
s,118,giving,211,51,2.31372549,169
overtly,46,likely,89,20,2.3,66
oaked,46,dryness,89,20,2.3,66
strained,46,ground,89,20,2.3,66
garnacha,46,rather,88,20,2.3,66
prosecco,46,among,88,20,2.3,66
airing,46,soften,88,20,2.3,66
zinfandel,128,about,234,56,2.285714286,184
we,45,lasting,88,20,2.25,65
spritzy,45,start,87,20,2.25,65
sulfur,45,tense,87,20,2.25,65
foxy,45,honeysuckle,87,20,2.25,65
unfocused,45,outstanding,87,20,2.25,65
wiry,45,melon,87,20,2.25,65
finishes,392,young,649,175,2.24,567
sparkler,58,life,108,26,2.230769231,84
seems,310,develop,542,139,2.230215827,449
semisweet,44,vintages,87,20,2.2,64
fading,44,river,86,20,2.2,64
lactic,44,layer,85,20,2.2,64
taste,327,some,575,150,2.18,477
like,1037,red,1594,481,2.155925156,1518
gum,43,grace,85,20,2.15,63
pink,119,verdot,213,56,2.125,175
soft,1589,cherry,2765,749,2.121495327,2338
tempranillo,72,down,133,34,2.117647059,106
aroma,194,apricot,356,92,2.108695652,286
cider,42,milk,82,20,2.1,62
sugared,42,cuv,82,20,2.1,62
fleeting,42,under,82,20,2.1,62
fruity,801,very,1289,383,2.091383812,1184
leathery,123,if,219,59,2.084745763,182
hay,58,emerge,108,28,2.071428571,86
raisin,155,forest,283,75,2.066666667,230
summer,62,streak,114,30,2.066666667,92
overall,203,perfumed,372,99,2.050505051,302
weird,41,sites,81,20,2.05,61
anywhere,41,above,81,20,2.05,61
moscato,41,amazing,81,20,2.05,61
cherry-berry,41,blueberries,80,20,2.05,61
grapy,41,youthfully,80,20,2.05,61
tad,41,hits,80,20,2.05,61
mulchy,41,rock,79,20,2.05,61
cheesy,41,bean,79,20,2.05,61
bubbly,41,mushroom,79,20,2.05,61
parties,41,sirah,78,20,2.05,61
choice,41,opulence,78,20,2.05,61
food,94,cool,167,46,2.043478261,140
clean,449,leather,745,224,2.004464286,673
starts,110,adds,199,55,2,165
cheese,56,how,103,28,2,84
direct,48,2028,91,24,2,72
prunes,40,sagebrush,77,20,2,60
scouring,40,TRUE,77,20,2,60
score,40,precise,77,20,2,60
fall,40,level,77,20,2,60
done,40,displays,76,20,2,60
alcohol,407,tobacco,725,205,1.985365854,612
appeal,87,grenache,153,44,1.977272727,131
rugged,51,combination,95,26,1.961538462,77
imported,39,raisin,75,20,1.95,59
anything,39,2011,75,20,1.95,59
except,39,attractive,75,20,1.95,59
jumbled,39,unfold,74,20,1.95,59
artificial,39,name,74,20,1.95,59
$,39,features,74,20,1.95,59
not,1179,dark,1854,608,1.939144737,1787
oranges,54,throughout,100,28,1.928571429,82
n't,636,raspberry,1004,330,1.927272727,966
difficult,50,peppercorn,94,26,1.923076923,76
hard,441,cassis,741,230,1.917391304,671
gaseous,38,including,74,20,1.9,58
cough,38,dominate,74,20,1.9,58
ultimately,38,hill,74,20,1.9,58
fast,38,freshly,74,20,1.9,58
italian,38,2015,72,20,1.9,58
quickly,89,2023,157,47,1.893617021,136
less,105,lavender,185,56,1.875,161
lightly,266,spices,462,142,1.873239437,408
side,233,style,402,125,1.864,358
water,37,2009,72,20,1.85,57
oddly,37,shine,72,20,1.85,57
metallic,37,mulberry,72,20,1.85,57
inexpensive,37,vivid,72,20,1.85,57
profile,127,hard,230,69,1.84057971,196
lot,138,supple,245,75,1.84,213
sweet,1852,ripe,3026,1011,1.831849654,2863
bubbles,42,parcel,82,23,1.826086957,65
mixed,73,been,133,40,1.825,113
drying,69,waves,126,38,1.815789474,107
does,452,new,758,251,1.800796813,703
pinched,36,40,70,20,1.8,56
abrasive,36,enjoyable,70,20,1.8,56
adequate,36,l,70,20,1.8,56
chicken,36,pair,69,20,1.8,56
fiery,36,based,69,20,1.8,56
chilled,36,meld,69,20,1.8,56
common,36,hills,69,20,1.8,56
sound,36,personality,69,20,1.8,56
some,1020,nose,1583,575,1.773913043,1595
sugar,244,coffee,436,138,1.768115942,382
butterscotch,105,feel,186,60,1.75,165
watermelon,35,accent,68,20,1.75,55
blocky,35,skins,68,20,1.75,55
higher,35,especially,68,20,1.75,55
grating,35,them,68,20,1.75,55
definition,35,attention,68,20,1.75,55
wo,35,loads,68,20,1.75,55
ham,35,root,67,20,1.75,55
past,68,side,125,39,1.743589744,107
cooked,47,2021,90,27,1.740740741,74
soda,40,decades,77,23,1.739130435,63
slight,102,keep,182,59,1.728813559,161
similar,43,blended,84,25,1.72,68
left,34,hibiscus,66,20,1.7,54
beans,34,sour,66,20,1.7,54
lost,34,unctuous,66,20,1.7,54
pasta,34,earthiness,66,20,1.7,54
job,34,edges,65,20,1.7,54
foods,34,dominated,65,20,1.7,54
kind,61,provides,112,36,1.694444444,97
buttery,93,de,166,55,1.690909091,148
pretty,284,earth,502,168,1.69047619,452
tart,667,full,1070,397,1.680100756,1064
juice,220,potential,390,133,1.654135338,353
thing,33,parts,65,20,1.65,53
mustard,33,equal,65,20,1.65,53
vinegar,33,fabulous,65,20,1.65,53
gummy,33,mark,65,20,1.65,53
grapey,33,world,65,20,1.65,53
fades,33,2035,64,20,1.65,53
dominating,33,completely,64,20,1.65,53
pungent,51,sea,96,31,1.64516129,82
nutty,72,juice,133,44,1.636363636,116
toward,93,varietal,165,57,1.631578947,150
salty,145,then,264,90,1.611111111,235
front,135,taut,238,84,1.607142857,219
tropical,331,which,593,206,1.606796117,537
lifesaver,32,rare,63,20,1.6,52
struggles,32,blends,63,20,1.6,52
feline,32,bursting,63,20,1.6,52
rusty,32,cured,63,20,1.6,52
ca,32,gorgeously,63,20,1.6,52
barbera,32,finest,63,20,1.6,52
helps,32,impeccable,63,20,1.6,52
gew,32,retains,62,20,1.6,52
attractively,32,detailed,62,20,1.6,52
sharpness,32,balances,62,20,1.6,52
horsey,32,2013,62,20,1.6,52
jalape,32,tongue,62,20,1.6,52
define,32,relatively,62,20,1.6,52
dominate,117,herbal,209,74,1.581081081,191
carob,36,mushrooms,69,23,1.565217391,59
help,53,absolutely,100,34,1.558823529,87
get,154,lingering,283,99,1.555555556,253
polish,31,oldest,62,20,1.55,51
torront,31,providing,62,20,1.55,51
sketchy,31,fermentation,62,20,1.55,51
cidery,31,place,61,20,1.55,51
mushy,31,sure,61,20,1.55,51
pruny,31,primary,61,20,1.55,51
veers,31,mingle,61,20,1.55,51
drawing,31,mandarin,61,20,1.55,51
bears,31,br,61,20,1.55,51
disappointing,31,base,60,20,1.55,51
clampy,31,property,60,20,1.55,51
suggestions,31,complexities,60,20,1.55,51
party,31,known,60,20,1.55,51
fans,31,poise,60,20,1.55,51
casual,31,create,60,20,1.55,51
dominant,57,ever,106,37,1.540540541,94
good,707,berry,1185,459,1.540305011,1166
use,43,winemaking,83,28,1.535714286,71
suggest,139,old,249,91,1.527472527,230
high,358,savory,630,235,1.523404255,593
prune,140,does,251,92,1.52173913,232
no,264,depth,461,174,1.517241379,438
jam,278,like,481,184,1.510869565,462
aftertaste,232,cedar,401,154,1.506493506,386
powdered,30,juniper,59,20,1.5,50
kiwi,30,allow,59,20,1.5,50
turning,30,7,59,20,1.5,50
misses,30,santa,59,20,1.5,50
curious,30,2,59,20,1.5,50
clipped,30,leathery,59,20,1.5,50
blush,30,exuberant,59,20,1.5,50
serve,30,2008,59,20,1.5,50
tire,30,poised,59,20,1.5,50
pineapple,395,bottling,653,264,1.496212121,659
enough,256,come,447,172,1.488372093,428
jelly,40,worth,77,27,1.481481481,67
carry,96,richly,169,65,1.476923077,161
acids,221,blueberry,390,150,1.473333333,371
briary,44,laced,85,30,1.466666667,74
offset,38,textural,73,26,1.461538462,64
leaving,83,slightly,147,57,1.456140351,140
bramble,45,example,87,31,1.451612903,76
clarity,29,owned,58,20,1.45,49
reedy,29,25,58,20,1.45,49
high-acid,29,scent,58,20,1.45,49
cutting,29,let,58,20,1.45,49
jagged,29,point,58,20,1.45,49
salad,29,class,58,20,1.45,49
fails,29,bringing,58,20,1.45,49
announce,29,age-worthy,58,20,1.45,49
precede,29,acidic,58,20,1.45,49
similarly,29,fascinating,57,20,1.45,49
popular,29,precision,57,20,1.45,49
sipper,29,run,57,20,1.45,49
would,150,was,267,105,1.428571429,255
flavors,6506,it,9911,4557,1.427693658,11063
value,47,salty,90,33,1.424242424,80
mouth,626,still,1000,441,1.419501134,1067
wide,34,streaks,65,24,1.416666667,58
yeasty,128,tangy,234,91,1.406593407,219
things,66,youthful,121,47,1.404255319,113
honeydew,35,nervy,68,25,1.4,60
recall,35,natural,68,25,1.4,60
upfront,35,2021,67,25,1.4,60
vegetables,28,50,57,20,1.4,48
looking,28,atop,57,20,1.4,48
cold,28,force,56,20,1.4,48
thus,28,presents,56,20,1.4,48
leesy,28,pink,56,20,1.4,48
distinctly,28,extreme,55,20,1.4,48
reasonably,28,hit,55,20,1.4,48
sb,28,typical,55,20,1.4,48
country-style,28,woodland,55,20,1.4,48
hickory,28,flashy,55,20,1.4,48
vinho,28,unique,55,20,1.4,48
verde,28,strawberries,54,20,1.4,48
nectarine,96,pretty,168,69,1.391304348,165
instead,32,late,62,23,1.391304348,55
peaches,93,california,165,67,1.388059701,160
definitely,36,coastal,69,26,1.384615385,62
o,73,grape,134,53,1.377358491,126
mouthfeel,490,time,833,356,1.376404494,846
viognier,99,finishes,175,72,1.375,171
leads,66,easily,121,48,1.375,114
tasted,44,fermented,86,32,1.375,76
going,140,tightly,253,102,1.37254902,242
mark,89,huge,159,65,1.369230769,154
seemingly,41,whole,80,30,1.366666667,71
residual,86,lots,151,63,1.365079365,149
surprisingly,53,linger,98,39,1.358974359,92
damp,27,swirl,54,20,1.35,47
substance,27,closes,54,20,1.35,47
average,27,special,54,20,1.35,47
organic,27,92-94,54,20,1.35,47
carmen,27,dazzling,54,20,1.35,47
powdery,27,o,53,20,1.35,47
matchstick,27,drive,53,20,1.35,47
pit,27,extended,53,20,1.35,47
viura,27,charm,53,20,1.35,47
bready,27,seem,52,20,1.35,47
cleansing,27,60,52,20,1.35,47
tasty,27,includes,52,20,1.35,47
seafood,27,benefit,52,20,1.35,47
wash,27,estate-grown,52,20,1.35,47
onto,58,stony,109,43,1.348837209,101
bite,58,impressively,107,43,1.348837209,101
american,31,memorable,61,23,1.347826087,54
dessert,101,certainly,178,75,1.346666667,176
finish,3286,flavors,4557,2441,1.346169603,5727
sweetness,324,beautiful,571,241,1.34439834,565
passion,43,may,84,32,1.34375,75
citrus,960,oak,1516,720,1.333333333,1680
match,44,suggesting,86,33,1.333333333,77
gently,40,lot,75,30,1.333333333,70
color,433,you,732,327,1.324159021,760
quite,264,good,459,200,1.32,464
leave,33,astringency,64,25,1.32,58
grape,176,ready,317,134,1.313432836,310
point,76,2016,141,58,1.310344828,134
aromas,3380,that,4751,2584,1.308049536,5964
apple,914,will,1515,702,1.301994302,1616
muscat,26,half,52,20,1.3,46
verdejo,26,brightness,52,20,1.3,46
pyrazines,26,fill,51,20,1.3,46
applesauce,26,woven,51,20,1.3,46
day,26,begin,51,20,1.3,46
sawdust,26,12,51,20,1.3,46
latex,26,appetizing,51,20,1.3,46
peachy,26,lightness,51,20,1.3,46
satisfy,26,bread,51,20,1.3,46
cheeses,26,enormously,51,20,1.3,46
no-fuss,26,blending,50,20,1.3,46
prickle,26,asphalt,50,20,1.3,46
however,74,seems,139,57,1.298245614,131
crisp,850,shows,1328,655,1.297709924,1505
gets,76,heady,141,59,1.288135593,135
prime,36,2026,69,28,1.285714286,64
buttered,167,make,299,130,1.284615385,297
chardonnay,489,lemon,823,381,1.283464567,870
crispness,64,nuances,118,50,1.28,114
terms,57,2030,105,45,1.266666667,102
ne,29,different,58,23,1.260869565,52
off,269,even,473,214,1.257009346,483
table,49,gentle,94,39,1.256410256,88
probably,59,jammy,110,47,1.255319149,106
borderline,25,decanting,50,20,1.25,45
volatility,25,cuts,50,20,1.25,45
piercing,25,impeccably,50,20,1.25,45
quaff,25,woody,50,20,1.25,45
neither,25,crispness,50,20,1.25,45
pulpy,25,distinct,50,20,1.25,45
beaujolais,25,contrast,50,20,1.25,45
stone-fruit,25,loam,50,20,1.25,45
noticeable,25,quince,49,20,1.25,45
stainless,25,produce,49,20,1.25,45
fair,25,port,49,20,1.25,45
tonic,25,substantial,49,20,1.25,45
dominates,51,continues,95,41,1.243902439,92
ends,37,cigar,71,30,1.233333333,67
colored,33,carry,65,27,1.222222222,60
flavor,657,structured,1070,538,1.221189591,1195
lemony,127,serious,232,104,1.221153846,231
qualities,28,sharp,56,23,1.217391304,51
gris,28,shape,56,23,1.217391304,51
may,102,where,181,84,1.214285714,186
cab,169,provide,301,140,1.207142857,309
say,35,ethereal,68,29,1.206896552,64
plump,119,grilled,213,99,1.202020202,218
bouquet,185,solid,342,154,1.201298701,339
round,197,winery,359,164,1.201219512,361
mango,120,do,217,100,1.2,220
frankly,24,olives,49,20,1.2,44
twice,24,marasca,49,20,1.2,44
peanut,24,dill,49,20,1.2,44
celery,24,nuts,49,20,1.2,44
innocuous,24,extraordinarily,49,20,1.2,44
nor,24,minty,48,20,1.2,44
wayward,24,classically,48,20,1.2,44
sensation,24,black-plum,48,20,1.2,44
affordable,24,seven,48,20,1.2,44
chinese,24,clearly,48,20,1.2,44
nettle,24,seriously,48,20,1.2,44
petrol,24,c,48,20,1.2,44
spritz,24,area,48,20,1.2,44
fruitless,24,love,48,20,1.2,44
main,24,added,48,20,1.2,44
control,24,brioche,48,20,1.2,44
vegetable,24,jasmine,47,20,1.2,44
towards,24,2033,47,20,1.2,44
pie-filling,24,pork,47,20,1.2,44
terribly,24,'re,47,20,1.2,44
subdued,44,impression,86,37,1.189189189,81
follow,38,away,73,32,1.1875,70
petite,97,cocoa,170,82,1.182926829,179
due,41,thanks,78,35,1.171428571,76
dry,1388,aromas,2584,1185,1.171308017,2573
sirah,91,enticing,161,78,1.166666667,169
hardly,28,shavings,55,24,1.166666667,52
offer,74,intriguing,138,64,1.15625,138
earthy,481,vanilla,800,417,1.153477218,898
include,61,brisk,112,53,1.150943396,114
sourness,23,blancs,47,20,1.15,43
sulfuric,23,probably,47,20,1.15,43
ne-style,23,2027,47,20,1.15,43
bubble,23,2031,47,20,1.15,43
either,23,things,47,20,1.15,43
i,23,cracked,46,20,1.15,43
'd,23,food,46,20,1.15,43
overoaked,23,box,46,20,1.15,43
people,23,farmed,46,20,1.15,43
coarse,23,combining,46,20,1.15,43
nondescript,23,low,46,20,1.15,43
fail,23,package,46,20,1.15,43
rztraminer,23,initial,46,20,1.15,43
millon,23,tartness,46,20,1.15,43
cotton,23,mouthfilling,46,20,1.15,43
puckering,23,graceful,46,20,1.15,43
fade,23,try,46,20,1.15,43
unripeness,23,steel,46,20,1.15,43
know,23,gold,45,20,1.15,43
bar,23,revealing,45,20,1.15,43
buy,23,put,45,20,1.15,43
effervescence,23,generosity,45,20,1.15,43
dose,23,cabernets,45,20,1.15,43
nero,23,ride,45,20,1.15,43
detracts,23,radiant,45,20,1.15,43
skins,78,cake,142,68,1.147058824,146
re,32,plus,62,28,1.142857143,60
sensations,32,lends,62,28,1.142857143,60
rh,49,reserve,93,43,1.139534884,92
middle,35,peaches,67,31,1.129032258,66
end,216,smoke,384,193,1.119170984,409
tone,47,framework,90,42,1.119047619,89
rest,38,douro,73,34,1.117647059,72
fact,29,toward,57,26,1.115384615,55
drop,39,dessert,75,35,1.114285714,74
edge,304,deep,539,274,1.109489051,578
tartness,51,botrytis,95,46,1.108695652,97
flavored,52,totally,97,47,1.106382979,99
soon,42,meyer,82,38,1.105263158,80
unoaked,22,clones,44,20,1.1,42
oxidation,22,stand,44,20,1.1,42
healthy,22,chamomile,44,20,1.1,42
bubblegum,22,since,44,20,1.1,42
sweet-and-sour,22,wealth,44,20,1.1,42
red-plum,22,remarkably,43,20,1.1,42
lodi,22,creek,43,20,1.1,42
deals,22,moist,43,20,1.1,42
freshener,22,rh,43,20,1.1,42
fish,22,italy,43,20,1.1,42
o.k,22,beguiling,43,20,1.1,42
trace,22,having,43,20,1.1,42
priced,22,onto,43,20,1.1,42
struggle,22,marks,43,20,1.1,42
prior,22,expertly,43,20,1.1,42
musky,22,strength,42,20,1.1,42
stem,22,road,42,20,1.1,42
roussanne,22,yes,42,20,1.1,42
fortunately,22,saffron,42,20,1.1,42
gentle,103,mountain,184,94,1.095744681,197
have,312,tannic,545,285,1.094736842,597
might,63,element,116,58,1.086206897,121
're,51,salt,96,47,1.085106383,98
brut,26,joy,52,24,1.083333333,50
or,639,sweet,1011,590,1.083050847,1229
tannic,589,aging,960,545,1.080733945,1134
followed,176,10,319,163,1.079754601,339
than,414,character,726,387,1.069767442,801
peach,554,so,918,518,1.069498069,1072
work,48,blanc,91,45,1.066666667,93
dominated,69,extremely,127,65,1.061538462,134
lemons,35,result,67,33,1.060606061,68
lemon-lime,36,potent,69,34,1.058823529,70
follows,36,delivering,69,34,1.058823529,70
berry,1251,now,2111,1185,1.055696203,2436
almond,180,n't,330,171,1.052631579,351
expect,42,petite,82,40,1.05,82
cava,21,citrusy,42,20,1.05,41
port-like,21,whiffs,42,20,1.05,41
suggestive,21,prominent,42,20,1.05,41
cantaloupe,21,tarry,42,20,1.05,41
quaffer,21,burst,42,20,1.05,41
wheaty,21,preserves,42,20,1.05,41
ruby,21,tone,42,20,1.05,41
marshmallow,21,dominates,41,20,1.05,41
compromised,21,think,41,20,1.05,41
walnut,21,see,41,20,1.05,41
expected,21,success,41,20,1.05,41
sits,21,scorched,41,20,1.05,41
grainy,21,speaks,40,20,1.05,41
monotone,21,ageability,40,20,1.05,41
chewing,21,bottlings,40,20,1.05,41
clunky,21,sanguine,40,20,1.05,41
distant,21,iconic,40,20,1.05,41
cheerful,21,nature,40,20,1.05,41
cuisine,21,alpine,40,20,1.05,41
extraction,43,front,84,41,1.048780488,84
italy,45,behind,87,43,1.046511628,88
ready,330,cinnamon,586,317,1.041009464,647
strawberry,348,not,608,335,1.03880597,683
varieties,62,forward,114,60,1.033333333,122
version,36,voluptuous,69,35,1.028571429,71
broad,74,always,137,72,1.027777778,146
brisk,115,appellation,205,112,1.026785714,227
air,41,ageworthy,80,40,1.025,81
peppery,201,blackberries,366,197,1.020304569,398
down,135,producer,238,133,1.015037594,268
if,222,can,393,219,1.01369863,441
extracted,79,bitter,143,78,1.012820513,157
tangy,236,lovely,418,234,1.008547009,470
close,114,alcohol,205,114,1,228
component,31,varieties,60,31,1,62
devoid,20,manages,40,20,1,40
excessive,20,oakville,40,20,1,40
unfortunately,20,tempting,40,20,1,40
alcoholic,20,paste,39,20,1,40
properly,20,becomes,39,20,1,40
light-,20,reduction,39,20,1,40
punchy,20,rutherford,39,20,1,40
salmon,20,defined,39,20,1,40
bulky,20,hands,39,20,1,40
bottles,20,weighty,39,20,1,40
creates,20,zestiness,39,20,1,40
off-putting,20,hazelnut,39,20,1,40
thrown,20,lean,39,20,1,40
basically,20,blossoms,39,20,1,40
points,20,stuff,39,20,1,40
problem,20,table,39,20,1,40
got,20,brawny,39,20,1,40
lightest,20,smells,39,20,1,40
marred,20,70,39,20,1,40
lambrusco,20,county,39,20,1,40
wax,20,wood-aged,39,20,1,40
ribs,20,sets,39,20,1,40
certain,20,flagship,39,20,1,40
s.h,20,viscous,38,20,1,40
rudimentary,20,enjoyed,38,20,1,40
scour,20,soon,38,20,1,40
moderately,20,limes,38,20,1,40
any,118,roasted,210,119,0.991596639,237
character,718,pepper,1193,726,0.988980716,1444
milk,81,future,145,82,0.987804878,163
syrup,70,elegantly,127,71,0.985915493,141
char,59,incredibly,109,60,0.983333333,119
caramelized,54,cr,101,55,0.981818182,109
typical,54,nuanced,100,55,0.981818182,109
maybe,40,decadent,77,41,0.975609756,81
blast,33,mousse,65,34,0.970588235,67
without,155,meat,284,160,0.96875,315
body,237,wines,429,245,0.967346939,482
particularly,26,moreish,51,27,0.962962963,53
northern,24,flavored,47,25,0.96,49
label,45,backed,88,47,0.957446809,92
had,22,powder,44,23,0.956521739,45
meats,43,richer,83,45,0.955555556,88
leaves,79,apples,143,83,0.951807229,162
lime,285,note,508,300,0.95,585
stale,19,powerhouse,38,20,0.95,39
stick,19,reward,38,20,0.95,39
sweetened,19,possibly,38,20,0.95,39
salinic,19,remaining,38,20,0.95,39
dog,19,pop,38,20,0.95,39
greens,19,dynamic,38,20,0.95,39
underdeveloped,19,2028,38,20,0.95,39
shearing,19,again,38,20,0.95,39
sweeter,19,project,38,20,0.95,39
vitality,19,central,38,20,0.95,39
blow,19,lighter,38,20,0.95,39
decidedly,19,filled,37,20,0.95,39
rooty,19,bordeaux-style,37,20,0.95,39
green-leaning,19,stunner,37,20,0.95,39
fur,19,early,37,20,0.95,39
largely,19,papaya,37,20,0.95,39
particular,19,runs,37,20,0.95,39
bath,19,remain,37,20,0.95,39
chilean,19,neutral,37,20,0.95,39
soap,19,clos,37,20,0.95,39
suit,19,wave,37,20,0.95,39
direction,19,intricate,37,20,0.95,39
red-currant,19,greatest,37,20,0.95,39
drunk,53,compote,99,56,0.946428571,109
charred,92,round,164,98,0.93877551,190
port,46,tremendous,88,49,0.93877551,95
lots,141,tangerine,254,151,0.933774834,292
pie,124,clean,224,133,0.932330827,257
run,53,charred,98,57,0.929824561,110
way,255,cellar,445,275,0.927272727,530
note,470,vintage,786,508,0.92519685,978
sturdy,24,southern,47,26,0.923076923,50
are,2237,palate,3599,2428,0.921334432,4665
limes,35,terrific,67,38,0.921052632,73
runs,34,sleek,66,37,0.918918919,71
early,34,cool-climate,66,37,0.918918919,71
successful,22,medium-bodied,44,24,0.916666667,46
call,22,touriga,43,24,0.916666667,46
touch,588,licorice,952,647,0.908809892,1235
nose,1431,its,2618,1583,0.903979785,3014
rhubarb,82,tar,145,91,0.901098901,173
suggestion,27,black-currant,53,30,0.9,57
overdone,18,kind,36,20,0.9,38
barrel-fermented,18,ability,36,20,0.9,38
acrid,18,surrounded,36,20,0.9,38
maderized,18,hedonistic,36,20,0.9,38
fizzy,18,stewed,36,20,0.9,38
shell,18,south,36,20,0.9,38
overt,18,conveys,36,20,0.9,38
sweet-tasting,18,roast,36,20,0.9,38
pickle,18,sources,36,20,0.9,38
overlay,18,nonetheless,36,20,0.9,38
running,18,dimension,36,20,0.9,38
lettuce,18,chunky,36,20,0.9,38
pinch,18,92,36,20,0.9,38
brine,18,deft,36,20,0.9,38
challenging,18,mind,36,20,0.9,38
mars,18,dr.,36,20,0.9,38
said,18,endless,36,20,0.9,38
country,18,waft,35,20,0.9,38
loud,18,drop,35,20,0.9,38
settles,18,gamy,35,20,0.9,38
jellied,18,rocky,35,20,0.9,38
severe,18,version,35,20,0.9,38
loses,18,evolution,35,20,0.9,38
akin,18,losing,35,20,0.9,38
semi-sweet,18,pleasantly,35,20,0.9,38
hide,18,straight,35,20,0.9,38
dash,18,pleasant,35,20,0.9,38
native,18,marjoram,35,20,0.9,38
oak-based,18,red-berry,35,20,0.9,38
ideal,18,domaine,35,20,0.9,38
disappointment,18,95,35,20,0.9,38
fried,18,juiciness,35,20,0.9,38
local,18,sniff,35,20,0.9,38
obvious,18,worthy,35,20,0.9,38
campfire,18,proving,34,20,0.9,38
there,1090,at,1604,1212,0.899339934,2302
remain,33,exciting,63,37,0.891891892,70
up,564,fine,923,633,0.890995261,1197
brambly,57,sangiovese,106,64,0.890625,121
astringency,57,notions,106,64,0.890625,121
appealing,57,game,105,64,0.890625,121
away,65,lengthy,119,73,0.890410959,138
austere,88,boasts,157,99,0.888888889,187
pairing,24,interest,48,27,0.888888889,51
on,3813,to,6151,4298,0.887156817,8111
skin,102,luscious,181,115,0.886956522,217
has,2013,acidity,3266,2272,0.886003521,4285
roasted,186,;,346,210,0.885714286,396
pronounced,23,amazingly,46,26,0.884615385,49
creamy,336,smoky,601,380,0.884210526,716
appears,30,mirabelle,59,34,0.882352941,64
scent,51,racy,96,58,0.879310345,109
orange,488,bright,808,555,0.879279279,1043
thick,187,first,348,213,0.877934272,400
what,199,baking,364,227,0.876651982,426
plummy,28,important,55,32,0.875,60
cracker,21,characteristics,42,24,0.875,45
saline,21,sprightly,41,24,0.875,45
while,1005,fruits,1570,1149,0.874673629,2154
vanilla,699,fresh,1164,800,0.87375,1499
hit,48,rhubarb,91,55,0.872727273,103
influence,27,chocolaty,53,31,0.870967742,58
lead,284,light,504,327,0.868501529,611
marked,66,given,121,76,0.868421053,142
drinks,52,cellaring,98,60,0.866666667,112
red,1380,?,2547,1594,0.86574655,2974
filling,43,apricots,84,50,0.86,93
baked,250,anise,440,291,0.859106529,541
spent,24,entry,48,28,0.857142857,52
plus,53,get,99,62,0.85483871,115
kick,34,reveal,66,40,0.85,74
stays,17,chablis,34,20,0.85,37
usa,17,tempranillo,34,20,0.85,37
pulse,17,dance,34,20,0.85,37
spain,17,alive,34,20,0.85,37
normally,17,lemon-lime,34,20,0.85,37
enjoyment,17,follows,34,20,0.85,37
chenin,17,silk,34,20,0.85,37
medium-weight,17,demands,34,20,0.85,37
creamed,17,appears,34,20,0.85,37
yield,17,des,34,20,0.85,37
peas,17,latest,34,20,0.85,37
chile,17,amarone,34,20,0.85,37
pasty,17,village,34,20,0.85,37
tomatoey,17,75,34,20,0.85,37
chocolate-covered,17,presence,34,20,0.85,37
pointed,17,auslese,34,20,0.85,37
hard-edged,17,punch,33,20,0.85,37
bouncy,17,signature,33,20,0.85,37
usually,17,du,33,20,0.85,37
drier,17,delicacy,33,20,0.85,37
food-friendly,17,welcome,33,20,0.85,37
try,39,adding,74,46,0.847826087,85
though,128,much,232,151,0.847682119,279
characteristic,22,ages,43,26,0.846153846,48
but,2848,drink,3823,3392,0.839622642,6240
do,182,gorgeous,335,217,0.838709677,399
warm,134,flowers,237,160,0.8375,294
result,56,lemony,104,67,0.835820896,123
quality,198,2018,359,237,0.835443038,435
bean,66,2024,120,79,0.835443038,145
cream,80,accents,144,96,0.833333333,176
strawberries,45,sophisticated,87,54,0.833333333,99
ripened,20,glorious,40,24,0.833333333,44
only,232,already,402,279,0.831541219,511
bring,54,going,102,65,0.830769231,119
with,9360,this,12009,11275,0.830155211,20635
signs,24,gracefully,47,29,0.827586207,53
almost,364,up,633,440,0.827272727,804
merlot,355,spicy,611,431,0.823665893,786
gold,37,nebbiolo,72,45,0.822222222,82
extract,27,turned,52,33,0.818181818,60
variety,111,olive,200,136,0.816176471,247
framing,26,clone,52,32,0.8125,58
superripe,30,crus,59,37,0.810810811,67
moderate,30,lees,59,37,0.810810811,67
then,214,silky,382,264,0.810606061,478
refreshing,115,six,206,142,0.809859155,257
;,280,rose,493,346,0.809248555,626
blend,795,cabernet,1236,983,0.808748728,1778
makes,173,offering,309,214,0.808411215,387
characterize,21,oregon,42,26,0.807692308,47
appearance,21,details,42,26,0.807692308,47
hint,321,layers,567,398,0.806532663,719
sweetly,25,production,49,31,0.806451613,56
leading,45,softly,87,56,0.803571429,101
shot,28,less,56,35,0.8,63
tannat,20,driven,39,25,0.8,45
heft,20,spiciness,39,25,0.8,45
sauerkraut,16,finished,33,20,0.8,36
shrill,16,smoothly,33,20,0.8,36
overpowering,16,pollen,33,20,0.8,36
albari,16,lemons,33,20,0.8,36
pruney,16,st.,33,20,0.8,36
cement,16,match,33,20,0.8,36
m.m,16,results,33,20,0.8,36
marginal,16,value,33,20,0.8,36
ammonia,16,tlese,33,20,0.8,36
acid-driven,16,produces,33,20,0.8,36
cookies,16,mountains,32,20,0.8,36
briney,16,granite,32,20,0.8,36
montepulciano,16,2005,32,20,0.8,36
vital,16,sunny,32,20,0.8,36
wintergreen,16,plummy,32,20,0.8,36
band-aid,16,2014,32,20,0.8,36
indistinct,16,16,32,20,0.8,36
malvasia,16,zin,32,20,0.8,36
others,16,entire,32,20,0.8,36
berry-cherry,16,sublime,32,20,0.8,36
quiet,16,framing,32,20,0.8,36
consistency,16,succulence,32,20,0.8,36
possible,16,tasted,32,20,0.8,36
quaffable,16,ageable,32,20,0.8,36
room,16,volume,32,20,0.8,36
harvest,16,producing,32,20,0.8,36
paired,16,surprising,31,20,0.8,36
flowery,16,cellared,31,20,0.8,36
greater,16,sweetly,31,20,0.8,36
feature,16,sipped,31,20,0.8,36
grapefruit,246,syrah,436,308,0.798701299,554
features,59,bordeaux,109,74,0.797297297,133
notes,1272,has,2272,1597,0.796493425,2869
weighty,31,vein,60,39,0.794871795,70
spring,27,upon,53,34,0.794117647,61
caramel,230,layered,400,290,0.793103448,520
found,23,energetic,47,29,0.793103448,52
used,23,toffee,47,29,0.793103448,52
streak,90,two,159,114,0.789473684,204
lighter,30,almonds,59,38,0.789473684,68
make,236,estate,419,299,0.789297659,535
fat,58,never,108,74,0.783783784,132
medium-sweet,18,meets,35,23,0.782608696,41
pears,64,grown,117,82,0.780487805,146
natural,53,drinkable,99,68,0.779411765,121
across,113,same,203,145,0.779310345,258
nature,31,crunchy,61,40,0.775,71
could,148,sip,265,191,0.77486911,339
stuff,30,equally,59,39,0.769230769,69
drinking,123,tones,221,160,0.76875,283
raspberry,771,there,1212,1004,0.767928287,1775
making,85,taste,150,111,0.765765766,196
about,179,lead,327,234,0.764957265,413
nacional,29,however,57,38,0.763157895,67
fruitiness,144,length,258,189,0.761904762,333
apricots,64,line,118,84,0.761904762,148
plum,833,more,1301,1099,0.757961783,1932
shy,31,char,60,41,0.756097561,72
highly,34,warmth,66,45,0.755555556,79
apples,108,framed,191,143,0.755244755,251
sangiovese,80,lifted,144,106,0.754716981,186
backed,66,fig,121,88,0.75,154
especially,51,focus,96,68,0.75,119
powder,33,rocks,64,44,0.75,77
ending,21,resulting,41,28,0.75,49
scattered,15,pungent,31,20,0.75,35
excessively,15,pleasing,31,20,0.75,35
generally,15,bramble,31,20,0.75,35
unpleasant,15,2004,31,20,0.75,35
tawny,15,rustic,31,20,0.75,35
issues,15,middle,31,20,0.75,35
old-vine,15,crust,31,20,0.75,35
spoiled,15,russian,31,20,0.75,35
veggies,15,puts,30,20,0.75,35
convincing,15,softened,30,20,0.75,35
moscatel,15,indian,30,20,0.75,35
tartaric,15,!,30,20,0.75,35
exactly,15,quinta,30,20,0.75,35
wrong,15,gently,30,20,0.75,35
burning,15,organically,30,20,0.75,35
wanting,15,amidst,30,20,0.75,35
valpolicella,15,funky,30,20,0.75,35
familiar,15,warmer,30,20,0.75,35
type,15,exuberance,30,20,0.75,35
seed,15,lusty,30,20,0.75,35
nail,15,blood,30,20,0.75,35
did,15,bolstered,30,20,0.75,35
raspy,15,suggestion,30,20,0.75,35
rosato,15,elaborate,30,20,0.75,35
honest,15,honeycomb,30,20,0.75,35
consumers,15,cranberries,29,20,0.75,35
leftover,15,say,29,20,0.75,35
crowd,15,hallmark,29,20,0.75,35
forceful,15,combined,29,20,0.75,35
d'avola,15,expresses,29,20,0.75,35
greenness,15,used,29,20,0.75,35
sipping,15,supremely,29,20,0.75,35
cocktail,15,mainly,29,20,0.75,35
tinged,15,slightest,29,20,0.75,35
settle,15,blockbuster,29,20,0.75,35
previous,15,found,29,20,0.75,35
likeable,15,signs,29,20,0.75,35
widely,15,subtlety,29,20,0.75,35
marks,32,perhaps,62,43,0.744186047,75
oak,1128,years,1781,1516,0.744063325,2644
county,29,peppercorns,57,39,0.743589744,68
addition,26,amounts,51,35,0.742857143,61
here,283,velvety,498,381,0.742782152,664
fresh,861,structure,1369,1164,0.739690722,2025
soften,65,months,119,88,0.738636364,153
characteristics,31,lavish,61,42,0.738095238,73
softness,31,drinks,60,42,0.738095238,73
palate,2654,tannins,3703,3599,0.737427063,6253
.,25776,and,36052,35356,0.729041747,61132
results,24,evident,49,33,0.727272727,57
a,12780,of,19178,17635,0.724695208,30415
chalky,71,your,128,98,0.724489796,169
strong,227,scents,396,314,0.722929936,541
molasses,26,pristine,52,36,0.722222222,62
apricot,257,comes,451,356,0.721910112,613
impression,62,entirely,114,86,0.720930233,148
touriga,31,butterscotch,60,43,0.720930233,74
suggests,71,extra,128,99,0.717171717,170
chocolaty,38,utterly,73,53,0.716981132,91
malbec,153,only,279,214,0.714953271,367
perhaps,44,approachable,86,62,0.709677419,106
interest,34,2014,66,48,0.708333333,82
edges,46,experience,88,65,0.707692308,111
accent,48,final,92,68,0.705882353,116
an,1428,rich,2589,2029,0.703794973,3457
although,199,most,363,284,0.700704225,483
asphalt,35,hearty,68,50,0.7,85
overtones,28,heat,55,40,0.7,68
inoffensive,14,look,29,20,0.7,34
pool,14,secondary,28,20,0.7,34
harshness,14,north,28,20,0.7,34
tinge,14,traditional,28,20,0.7,34
mouth-puckering,14,m,28,20,0.7,34
sweat,14,highlighted,28,20,0.7,34
uncomplicated,14,maintains,28,20,0.7,34
official,14,gradually,28,20,0.7,34
impress,14,holding,28,20,0.7,34
earn,14,dramatically,28,20,0.7,34
cinsault,14,sensations,28,20,0.7,34
sappy,14,slopes,28,20,0.7,34
struggling,14,he,28,20,0.7,34
stay,14,steve,28,20,0.7,34
severely,14,charcoal,28,20,0.7,34
served,14,hefty,28,20,0.7,34
minor,14,peat,28,20,0.7,34
pick,14,rewarding,28,20,0.7,34
sticks,14,coiled,28,20,0.7,34
semisour,14,guava,28,20,0.7,34
onion,14,sophistication,28,20,0.7,34
marsanne,14,waiting,28,20,0.7,34
available,14,citric,28,20,0.7,34
act,14,describe,28,20,0.7,34
steam,14,spine,28,20,0.7,34
j.c,14,tree,28,20,0.7,34
spearmint,14,tender,28,20,0.7,34
spoils,14,use,28,20,0.7,34
ordinary,14,countered,28,20,0.7,34
tell,14,days,28,20,0.7,34
consistent,14,bark,28,20,0.7,34
indicates,14,cooked,27,20,0.7,34
heaviness,14,composed,27,20,0.7,34
beet,14,underripe,27,20,0.7,34
meals,14,carneros,27,20,0.7,34
persists,14,contribute,27,20,0.7,34
appetizers,14,twist,27,20,0.7,34
cover,14,notable,27,20,0.7,34
mangoes,14,2010,27,20,0.7,34
masked,14,large,27,20,0.7,34
trying,14,resin,27,20,0.7,34
ager,14,proper,27,20,0.7,34
purposes,14,supports,27,20,0.7,34
eventually,14,lee,27,20,0.7,34
horse,14,breathing,27,20,0.7,34
cheeseburger,14,allows,27,20,0.7,34
farmyard,14,rises,27,20,0.7,34
occasions,14,gr,27,20,0.7,34
pear,389,touch,647,558,0.697132616,947
varietal,115,tropical,206,165,0.696969697,280
punch,23,riserva,47,33,0.696969697,56
zippy,16,pedigree,32,23,0.695652174,39
white,687,dense,1126,988,0.69534413,1675
tang,41,cases,78,59,0.694915254,100
nuts,34,peak,66,49,0.693877551,83
becomes,27,youth,54,39,0.692307692,66
those,107,smoked,189,155,0.690322581,262
start,60,brown,112,87,0.689655172,147
wet,108,brooding,192,157,0.687898089,265
whole,55,me,103,80,0.6875,135
drinkable,68,highlights,125,99,0.686868687,167
style,276,glass,477,402,0.686567164,678
pinot,438,freshness,736,638,0.686520376,1076
likely,61,promise,113,89,0.685393258,150
fruit,3045,fruit,4444,4444,0.685193519,7489
final,63,skin,115,92,0.684782609,155
fleshy,78,refreshing,142,114,0.684210526,192
mushroom,54,2016,102,79,0.683544304,133
tones,151,edge,274,221,0.683257919,372
find,97,almond,171,142,0.683098592,239
and,24613,.,35356,36052,0.68270831,60665
your,87,those,155,128,0.6796875,215
cut,110,plums,199,162,0.679012346,272
spiced,76,lightly,142,112,0.678571429,188
traditional,19,exquisitely,37,28,0.678571429,47
forward,77,single-vineyard,142,114,0.675438596,191
which,400,crisp,655,593,0.674536256,993
sauvignon,406,citrus,720,602,0.674418605,1008
syrah,293,peach,518,436,0.672018349,729
set,88,superb,157,131,0.671755725,219
acidity,2181,but,3392,3266,0.667789345,5447
offers,531,into,901,796,0.667085427,1327
bread,34,mediterranean,66,51,0.666666667,85
prominent,28,drunk,56,42,0.666666667,70
whiffs,28,lip-smacking,55,42,0.666666667,70
rise,28,powered,55,42,0.666666667,70
contains,18,due,35,27,0.666666667,45
other,132,bodied,236,199,0.663316583,331
because,49,2010,94,74,0.662162162,123
amount,41,become,80,62,0.661290323,103
late,41,holds,79,62,0.661290323,103
southern,31,funk,60,47,0.659574468,78
pleasantly,23,appeal,44,35,0.657142857,58
juiciness,23,classy,44,35,0.657142857,58
touched,23,burgundy,44,35,0.657142857,58
gives,213,chardonnay,381,325,0.655384615,538
this,7827,with,11275,12009,0.651761179,19836
you,477,offers,796,732,0.651639344,1209
faded,13,overly,27,20,0.65,33
picture,13,contains,27,20,0.65,33
recommend,13,apart,27,20,0.65,33
soda-like,13,coating,27,20,0.65,33
break,13,lending,27,20,0.65,33
sherry,13,needle,26,20,0.65,33
vague,13,appearance,26,20,0.65,33
blows,13,bouschet,26,20,0.65,33
blowsy,13,characterize,26,20,0.65,33
charming,13,rugged,26,20,0.65,33
indicate,13,mineral-driven,26,20,0.65,33
smokiness,13,tingling,26,20,0.65,33
overwhelms,13,lemongrass,26,20,0.65,33
veering,13,hand,26,20,0.65,33
overwhelming,13,ash,26,20,0.65,33
dimensional,13,ease,26,20,0.65,33
pyrazinic,13,deliver,26,20,0.65,33
unconvincing,13,sturdy,26,20,0.65,33
bearing,13,characteristic,26,20,0.65,33
primitivo,13,longtime,26,20,0.65,33
grab,13,d,26,20,0.65,33
buried,13,sparkler,26,20,0.65,33
looks,13,fairly,26,20,0.65,33
heavy-handed,13,nectar,26,20,0.65,33
mendocino,13,owner,26,20,0.65,33
overripeness,13,cabs,26,20,0.65,33
max,13,otherwise,26,20,0.65,33
entry-level,13,fact,26,20,0.65,33
burger,13,delightfully,26,20,0.65,33
mushroomy,13,evolving,26,20,0.65,33
curiously,13,becoming,25,20,0.65,33
snap,13,persistence,25,20,0.65,33
green-herb,13,northern,25,20,0.65,33
says,13,splendid,25,20,0.65,33
equivalent,13,tempered,25,20,0.65,33
following,13,whole-cluster,25,20,0.65,33
poultry,13,signals,25,20,0.65,33
picnics,13,enveloping,25,20,0.65,33
33,13,showcase,25,20,0.65,33
category,13,garrigue,25,20,0.65,33
florals,13,les,25,20,0.65,33
meant,13,exudes,25,20,0.65,33
unlikely,13,fluid,25,20,0.65,33
consumed,13,heft,25,20,0.65,33
shellfish,13,located,25,20,0.65,33
di,13,district,25,20,0.65,33
salads,13,impact,25,20,0.65,33
pour,13,dosage,25,20,0.65,33
orchard,13,leave,25,20,0.65,33
despite,123,cru,219,190,0.647368421,313
is,7281,is,11250,11250,0.6472,18531
butter,64,modern,117,99,0.646464646,163
racy,62,2022,114,96,0.645833333,158
far,47,yeasty,91,73,0.643835616,120
size,16,surely,31,25,0.64,41
been,85,loaded,151,133,0.639097744,218
south,23,released,45,36,0.638888889,59
something,74,sugar,138,116,0.637931034,190
's,3692,from,5112,5788,0.637871458,9480
simply,45,additional,87,71,0.633802817,116
bordeaux,69,pressed,126,109,0.633027523,178
softly,55,longer,102,87,0.632183908,142
along,308,after,540,488,0.631147541,796
softer,17,superbly,33,27,0.62962963,44
sauce,61,20,113,97,0.628865979,158
currant,347,crushed,606,552,0.628623188,899
gamy,22,packs,44,35,0.628571429,57
cherry,1736,for,2810,2765,0.627848101,4501
that,2981,on,4298,4751,0.627446853,7732
field,30,lamb,59,48,0.625,78
come,279,big,483,447,0.624161074,726
interesting,61,his,112,98,0.62244898,159
rind,48,were,91,78,0.615384615,126
cherries,312,currant,552,511,0.610567515,823
behind,53,plump,99,87,0.609195402,140
stems,14,softer,27,23,0.608695652,37
to,3744,'s,5788,6151,0.608681515,9895
brown,68,ginger,124,112,0.607142857,180
blended,51,reveals,96,84,0.607142857,135
reminiscent,38,powerfully,72,63,0.603174603,101
hints,278,least,480,461,0.603036876,739
bodied,142,sense,256,236,0.601694915,378
back,87,6,153,145,0.6,232
means,21,2029,41,35,0.6,56
vibrancy,15,word,29,25,0.6,40
ashy,12,size,25,20,0.6,32
mute,12,earl,25,20,0.6,32
shoe,12,retaining,25,20,0.6,32
overwhelm,12,upfront,25,20,0.6,32
offputting,12,turns,25,20,0.6,32
underwhelming,12,tannat,25,20,0.6,32
overriding,12,slope,25,20,0.6,32
downright,12,must,25,20,0.6,32
took,12,original,25,20,0.6,32
none,12,frames,25,20,0.6,32
beets,12,93,25,20,0.6,32
ago,12,tantalizing,24,20,0.6,32
gluey,12,14,24,20,0.6,32
gamay,12,steep,24,20,0.6,32
hue,12,direct,24,20,0.6,32
older,12,saline,24,20,0.6,32
abundance,12,biodynamic,24,20,0.6,32
serviceable,12,tarragon,24,20,0.6,32
scented,12,wrap,24,20,0.6,32
correct,12,mixes,24,20,0.6,32
kool-aid,12,art,24,20,0.6,32
abrupt,12,well-crafted,24,20,0.6,32
deal,12,olallieberry,24,20,0.6,32
traces,12,successful,24,20,0.6,32
flaws,12,hallmarks,24,20,0.6,32
spectrum,12,call,24,20,0.6,32
chianti,12,lick,24,20,0.6,32
sit,12,beneath,24,20,0.6,32
tan,12,acacia,24,20,0.6,32
monterey,12,wow,24,20,0.6,32
somewhere,12,ripest,24,20,0.6,32
scoury,12,damson,24,20,0.6,32
normal,12,light-footed,24,20,0.6,32
green-fruit,12,deserves,24,20,0.6,32
needed,12,tradition,24,20,0.6,32
excess,12,coat,24,20,0.6,32
creating,12,leap,24,20,0.6,32
heavier,12,endlessly,24,20,0.6,32
feed,12,zippy,23,20,0.6,32
crisply,12,ne,23,20,0.6,32
reflects,12,developed,23,20,0.6,32
content,12,finally,23,20,0.6,32
recalls,12,austerity,23,20,0.6,32
topped,12,carob,23,20,0.6,32
entrance,12,longevity,23,20,0.6,32
stiff,12,reserve-level,23,20,0.6,32
bead,12,fore,23,20,0.6,32
iodine,12,stems,23,20,0.6,32
brittle,12,darkly,23,20,0.6,32
ruby-colored,12,american,23,20,0.6,32
seeming,12,undertones,23,20,0.6,32
dish,12,merest,23,20,0.6,32
minimal,12,small-production,23,20,0.6,32
wan,12,graham,23,20,0.6,32
compromise,12,barbaresco,23,20,0.6,32
foam,12,instead,23,20,0.6,32
barbecued,12,elusive,23,20,0.6,32
bittersweet,12,build,23,20,0.6,32
carries,52,compact,98,87,0.597701149,139
noir,223,mocha,393,374,0.596256684,597
jasmine,28,defines,54,47,0.595744681,75
element,69,continue,127,116,0.594827586,185
grenache,91,wonderfully,161,153,0.594771242,244
surface,22,ranch,43,37,0.594594595,59
wave,22,bite,43,37,0.594594595,59
proper,16,turn,33,27,0.592592593,43
70,23,stellar,47,39,0.58974359,62
it,5842,wine,9223,9911,0.58944607,15753
wine,5426,?,7505,9223,0.588311829,14649
plenty,144,berries,258,245,0.587755102,389
grapes,175,bold,312,299,0.585284281,474
dryness,52,sauce,97,89,0.584269663,141
create,35,form,67,60,0.583333333,95
tarragon,14,particularly,27,24,0.583333333,38
tongue,36,flinty,70,62,0.580645161,98
really,101,bit,179,174,0.58045977,275
out,464,best,778,800,0.58,1264
nearly,33,second,64,57,0.578947368,90
berries,149,delicate,266,258,0.57751938,407
finishing,82,across,145,142,0.577464789,224
hand,15,approach,29,26,0.576923077,41
goes,42,leaves,83,73,0.575342466,115
nut,27,deliciousness,52,47,0.574468085,74
made,339,concentration,602,593,0.571669477,932
brightened,28,saturated,54,49,0.571428571,77
guava,16,syrahs,31,28,0.571428571,44
just,449,soft,749,786,0.571246819,1235
lemon,470,mineral,794,823,0.571081409,1293
dusty,137,ripeness,244,240,0.570833333,377
in,4180,in,7387,7387,0.565858941,11567
bright,457,also,776,808,0.565594059,1265
initial,26,fragrance,51,46,0.565217391,72
never,61,cardamom,113,108,0.564814815,169
bone-dry,18,awesome,34,32,0.5625,50
distinct,28,promising,55,50,0.56,78
current,14,cheese,28,25,0.56,39
equally,33,exquisite,64,59,0.559322034,92
be,497,powerful,850,895,0.555307263,1392
go,86,pine,151,155,0.55483871,241
viscous,21,showcases,41,38,0.552631579,59
red-cherry,16,evolves,32,29,0.551724138,45
bone,43,want,84,78,0.551282051,121
quince,27,flavorful,53,49,0.551020408,76
amounts,28,zinfandel,56,51,0.549019608,79
zesty,124,few,222,226,0.548672566,350
stand,24,well-balanced,48,44,0.545454545,68
lively,157,2020,289,288,0.545138889,445
spicy,332,made,593,611,0.543371522,943
underlying,39,because,74,72,0.541666667,111
acacia,13,eastern,25,24,0.541666667,37
mint,190,mint,351,351,0.541310541,541
minerally,34,sumptuous,65,63,0.53968254,97
the,14268,the,26438,26438,0.539677737,40706
deliver,14,oranges,28,26,0.538461538,40
",",28042,",",52084,52084,0.538399508,80126
personality,37,velvet,71,69,0.536231884,106
shape,30,nuance,59,56,0.535714286,86
north,15,intrigue,31,28,0.535714286,43
describe,15,summer,30,28,0.535714286,43
giving,113,graphite,202,211,0.535545024,324
floral,208,creamy,380,389,0.53470437,597
toast,301,flavor,538,567,0.530864198,868
throughout,53,yeast,100,100,0.53,153
40,37,2027,71,70,0.528571429,107
honeyed,78,find,142,148,0.527027027,226
better,119,rounded,213,226,0.526548673,345
pop,20,supportive,39,38,0.526315789,58
central,20,effortlessly,39,38,0.526315789,58
hinting,21,why,40,40,0.525,61
burst,22,clear,42,42,0.523809524,64
mourv,58,four,108,111,0.522522523,169
also,405,apple,702,776,0.521907216,1181
undertones,12,wide,24,23,0.52173913,35
amid,13,vibrancy,25,25,0.52,38
rises,14,ending,28,27,0.518518519,41
very,668,plum,1099,1289,0.518231187,1957
entirely,59,making,111,114,0.51754386,173
look,15,team,30,29,0.517241379,44
approach,15,red-cherry,29,29,0.517241379,44
appear,32,',62,62,0.516129032,94
fruits,809,well,1291,1570,0.515286624,2379
of,9854,a,17635,19178,0.513817916,29032
defined,20,surprisingly,39,39,0.512820513,59
who,61,wound,112,119,0.512605042,180
see,21,layering,41,41,0.512195122,62
cocoa,87,bouquet,154,170,0.511764706,257
herbs,234,yellow,405,458,0.510917031,692
toffee,24,expensive,47,47,0.510638298,71
aromatically,27,easy,54,53,0.509433962,80
underneath,29,leaving,57,57,0.50877193,86
weight,180,stone,332,355,0.507042254,535
level,39,fat,74,77,0.506493506,116
scents,199,),361,396,0.502525253,595
toasted,110,other,199,220,0.5,330
accents,72,doles,132,144,0.5,216
suggesting,43,mellow,85,86,0.5,129
half,26,extraordinary,52,52,0.5,78
steel,23,course,46,46,0.5,69
course,23,work,45,46,0.5,69
case,20,overtones,40,40,0.5,60
clay,18,super,36,36,0.5,54
dimension,18,lifts,35,36,0.5,54
conveys,18,flamboyant,35,36,0.5,54
lusty,15,ros,29,30,0.5,45
ed,12,similar,25,24,0.5,36
14,12,levels,25,24,0.5,36
rounded,106,planted,186,213,0.497652582,319
months,59,long-term,109,119,0.495798319,178
dre,56,lingers,103,113,0.495575221,169
meaty,51,penetrating,95,103,0.495145631,154
more,641,balanced,1022,1301,0.492697925,1942
shiraz,28,leading,56,57,0.49122807,85
unique,27,aromatically,53,55,0.490909091,82
for,1379,finish,2441,2810,0.490747331,4189
charm,26,decant,52,53,0.490566038,79
dill,24,dust,49,49,0.489795918,73
ride,22,apparent,43,45,0.488888889,67
name,36,profile,69,74,0.486486486,110
completely,31,impresses,61,64,0.484375,95
region,44,built,86,91,0.483516484,135
(,173,grapefruit,308,358,0.483240223,531
honeysuckle,42,perfume,81,87,0.482758621,129
raspberries,105,compelling,186,218,0.481651376,323
apart,13,2012,26,27,0.481481481,40
coating,13,grey,26,27,0.481481481,40
large,13,current,25,27,0.481481481,40
as,1142,through,1795,2378,0.480235492,3520
cuts,24,label,47,50,0.48,74
speak,12,proportioned,25,25,0.48,37
stuffing,12,soda,23,25,0.48,37
tannin,104,further,184,217,0.479262673,321
),173,before,306,361,0.479224377,534
backdrop,23,magnificent,45,48,0.479166667,71
based,33,brambly,64,69,0.47826087,102
blackberries,174,:,310,366,0.475409836,540
50,27,irresistible,53,57,0.473684211,84
background,52,black-fruit,98,110,0.472727273,162
given,57,coconut,105,121,0.47107438,178
whose,24,washington,47,51,0.470588235,75
they,100,grand,178,213,0.469483568,313
16,15,creaminess,30,32,0.46875,47
relatively,29,flint,57,62,0.467741935,91
organically,14,muscle,27,30,0.466666667,44
mix,139,blue,246,298,0.466442953,437
approachable,40,shines,76,86,0.465116279,126
olive,93,sample,165,200,0.465,293
tree,13,rum,26,28,0.464285714,41
bark,13,absolute,26,28,0.464285714,41
texture,643,delicious,1024,1385,0.464259928,2028
immediately,45,seamless,87,97,0.463917526,142
think,19,sp,37,41,0.463414634,60
form,31,coast,61,67,0.462686567,98
touches,80,accented,143,173,0.462427746,253
were,42,30,83,91,0.461538462,133
structural,12,mount,25,26,0.461538462,38
lemongrass,12,counterpoint,24,26,0.461538462,38
cool,77,midpalate,142,167,0.461077844,244
two,73,small,136,159,0.459119497,232
by,1043,notes,1597,2272,0.459066901,3315
golden,49,prune,92,107,0.457943925,156
waft,16,lusciously,33,35,0.457142857,51
show,179,color,327,394,0.454314721,573
strongly,48,single,91,106,0.452830189,154
flavorful,24,dazzles,47,53,0.452830189,77
black-currant,24,quickly,47,53,0.452830189,77
shows,601,blend,983,1328,0.452560241,1929
honey,215,polished,383,476,0.451680672,691
was,120,2017,217,267,0.449438202,387
dust,22,famous,43,49,0.448979592,71
pastry,26,balancing,52,58,0.448275862,84
80,13,ridge,26,29,0.448275862,42
word,13,structural,26,29,0.448275862,42
combined,13,honeydew,25,29,0.448275862,42
riesling,94,these,167,210,0.447619048,304
custard,17,help,34,38,0.447368421,55
again,17,blast,34,38,0.447368421,55
real,38,expressive,73,85,0.447058824,123
lending,12,had,23,27,0.444444444,39
includes,23,marzipan,45,52,0.442307692,75
them,30,gets,59,68,0.441176471,98
lees,26,spectacular,52,59,0.440677966,85
being,61,named,113,139,0.438848921,200
cola,236,next,420,538,0.43866171,774
opening,35,soy,67,80,0.4375,115
itself,45,carries,87,103,0.436893204,148
midpalate,62,developing,114,142,0.436619718,204
extreme,24,thoroughly,49,55,0.436363636,79
franc,128,fragrant,234,294,0.43537415,422
at,698,while,1149,1604,0.435162095,2302
wood,330,or,590,760,0.434210526,1090
edged,13,energizing,26,30,0.433333333,43
softened,13,vibrantly,26,30,0.433333333,43
blackened,13,highlight,25,30,0.433333333,43
creaminess,13,usual,25,30,0.433333333,43
filled,16,unusual,33,37,0.432432432,53
grilled,92,several,164,213,0.431924883,305
lasting,38,broad,72,88,0.431818182,126
oil,28,underneath,57,65,0.430769231,93
cranberry,145,2022,264,338,0.428994083,483
enjoyable,30,slight,59,70,0.428571429,100
evident,21,lineup,41,49,0.428571429,70
straight,15,invigorating,30,35,0.428571429,50
spine,12,total,23,28,0.428571429,40
nicely,53,interesting,98,124,0.427419355,177
under,35,streamlined,68,82,0.426829268,117
when,29,distinctive,58,68,0.426470588,97
60,22,toastiness,43,52,0.423076923,74
effort,43,takes,84,102,0.421568627,145
open,85,finely,150,203,0.418719212,288
'll,66,combines,121,158,0.417721519,224
takes,35,when,68,84,0.416666667,119
mind,15,blackened,30,36,0.416666667,51
dr.,15,vineyard-designate,29,36,0.416666667,51
oregano,34,oil,65,82,0.414634146,116
beyond,53,overall,99,128,0.4140625,181
tight,236,earthy,417,573,0.411867365,809
alive,14,hails,27,34,0.411764706,48
lend,37,center,71,90,0.411111111,127
part,38,goes,73,93,0.408602151,131
keeps,38,far,73,93,0.408602151,131
brand,13,pronounced,26,32,0.40625,45
rioja,15,walla,30,37,0.405405405,52
flowers,96,steely,170,237,0.405063291,333
holds,32,array,62,79,0.405063291,111
offering,125,better,226,309,0.404530744,434
smoky,243,both,431,601,0.404326123,844
where,73,improve,134,181,0.403314917,254
opens,214,2020,381,532,0.402255639,746
blackberry,579,yet,927,1440,0.402083333,2019
chewy,78,finishing,142,195,0.4,273
display,14,vine,28,35,0.4,49
different,23,highly,45,58,0.396551724,81
love,19,umami,38,48,0.395833333,67
added,19,redolent,38,48,0.395833333,67
robust,36,persistent,68,91,0.395604396,127
redolent,15,smoothness,30,38,0.394736842,53
center,28,delicately,55,71,0.394366197,99
extremely,50,brunello,94,127,0.393700787,177
pepper,468,should,780,1193,0.392288349,1661
accented,56,tilled,103,143,0.391608392,199
cabernet,484,out,800,1236,0.391585761,1720
box,18,barely,35,46,0.391304348,64
bacon,48,suggest,91,123,0.390243902,171
tangerine,99,e,174,254,0.38976378,353
initially,26,94,51,67,0.388059701,93
hits,31,appear,62,80,0.3875,111
few,86,though,151,222,0.387387387,308
fermentation,24,backdrop,48,62,0.387096774,86
surprising,12,shadings,25,31,0.387096774,43
exhibits,12,ripened,24,31,0.387096774,43
steak,22,harmony,43,57,0.385964912,79
30,32,accessible,63,83,0.385542169,115
leaf,67,restrained,123,174,0.385057471,241
balancing,20,starting,39,52,0.384615385,72
herb,248,lush,439,645,0.384496124,893
provides,43,supported,83,112,0.383928571,155
base,23,morello,47,60,0.383333333,83
big,185,zest,341,483,0.383022774,668
flower,103,jam,184,269,0.382899628,372
game,40,keeping,77,105,0.380952381,145
preserves,16,bone-dry,32,42,0.380952381,58
20,43,black-cherry,84,113,0.380530973,156
give,250,almost,440,657,0.380517504,907
once,35,initially,67,92,0.380434783,127
showing,178,gives,325,470,0.378723404,648
bordeaux-style,14,syrupy,28,37,0.378378378,51
brings,91,warm,160,241,0.377593361,332
black-fruit,37,simply,71,98,0.37755102,135
balance,279,along,488,740,0.377027027,1019
own,41,opening,80,109,0.376146789,150
now,793,vineyard,1220,2111,0.37565135,2904
sunny,12,ed,24,32,0.375,44
take,66,alluring,120,177,0.372881356,243
comes,168,lime,300,451,0.372505543,619
present,26,unwind,51,70,0.371428571,96
losing,13,speak,25,35,0.371428571,48
maple,23,te,44,62,0.370967742,85
perfume,30,tang,59,81,0.37037037,111
currants,123,raspberries,218,335,0.367164179,458
funk,22,nutty,44,60,0.366666667,82
benefit,19,ways,38,52,0.365384615,71
freshly,27,teau,53,74,0.364864865,101
moment,16,fills,31,44,0.363636364,60
date,12,cracker,24,33,0.363636364,45
produces,12,qualities,23,33,0.363636364,45
grip,37,beginning,70,102,0.362745098,139
pork,17,savor,34,47,0.361702128,64
feral,13,buoyant,26,36,0.361111111,49
super,13,cooking,26,36,0.361111111,49
spiciness,14,breadth,27,39,0.358974359,53
tar,52,iron,98,145,0.35862069,197
upon,19,noirs,37,53,0.358490566,72
stone,119,makes,214,332,0.358433735,451
adds,71,ample,129,199,0.35678392,270
spice,737,age,1206,2069,0.35621073,2806
%,652,juicy,1055,1831,0.356089569,2483
juniper,21,detail,42,59,0.355932203,80
lamb,21,kick,40,59,0.355932203,80
pith,27,remarkable,54,76,0.355263158,103
around,99,leaf,174,279,0.35483871,378
tannins,1306,are,2428,3703,0.352687011,5009
fully,59,mourv,111,168,0.351190476,227
TRUE,27,black-skinned,53,77,0.350649351,104
luminous,14,dusted,27,40,0.35,54
cured,22,lilac,42,63,0.349206349,85
accessible,22,softness,42,63,0.349206349,85
can,137,plenty,245,393,0.348600509,530
enjoy,55,brilliant,102,158,0.348101266,213
solid,119,thick,213,342,0.347953216,461
coming,41,bone,78,118,0.347457627,159
into,313,orange,555,901,0.347391787,1214
combination,33,appealing,64,95,0.347368421,128
produce,17,pineapples,33,49,0.346938776,66
production,17,various,33,49,0.346938776,66
delicate,92,violets,162,266,0.345864662,358
riper,20,sultry,38,58,0.344827586,78
ripeness,84,wrapped,148,244,0.344262295,328
place,21,air,40,61,0.344262295,82
right,117,riesling,210,340,0.344117647,457
flesh,24,field,48,70,0.342857143,94
keep,62,fleshy,114,182,0.340659341,244
presents,19,surface,37,56,0.339285714,75
drink,1292,by,2272,3823,0.337954486,5115
pleasure,26,ahead,51,77,0.337662338,103
toasty,108,despite,190,321,0.336448598,429
all,400,give,657,1191,0.335852225,1591
tea,98,succulent,173,292,0.335616438,390
want,28,starts,55,84,0.333333333,112
saturated,18,often,36,54,0.333333333,72
closes,18,addition,35,54,0.333333333,72
yes,14,bottled,28,42,0.333333333,56
driven,13,lies,26,39,0.333333333,52
starting,13,astonishing,26,39,0.333333333,52
chocolate,369,pinot,638,1114,0.331238779,1483
even,155,although,284,473,0.32769556,628
its,856,concentrated,1340,2618,0.32696715,3474
aromatics,30,fudge,59,92,0.326086957,122
package,15,bing,29,46,0.326086957,61
why,13,blocks,27,40,0.325,53
first,113,pomegranate,204,348,0.324712644,461
high-toned,33,hugely,64,102,0.323529412,135
warmth,21,hinting,40,66,0.318181818,87
ample,41,tiny,78,129,0.317829457,170
blends,20,series,38,63,0.317460317,83
resulting,13,allied,27,41,0.317073171,54
before,97,enough,172,306,0.316993464,403
expressive,23,terms,45,73,0.315068493,96
special,17,delightful,34,54,0.314814815,71
closed,33,offer,64,105,0.314285714,138
silky,120,espresso,215,382,0.314136126,502
12,16,thrilling,32,51,0.31372549,67
blueberry,122,2017,217,390,0.312820513,512
coffee,136,dusty,240,436,0.311926606,572
sheer,29,held,57,93,0.311827957,122
put,14,alicante,28,45,0.311111111,59
let,18,means,35,58,0.310344828,76
over,228,tart,397,735,0.310204082,963
pressed,39,inky,74,126,0.30952381,165
tarry,13,extends,26,42,0.30952381,55
cases,24,allowing,48,78,0.307692308,102
paste,12,brut,24,39,0.307692308,51
hazelnut,12,boasting,23,39,0.307692308,51
sets,12,tuscan,23,39,0.307692308,51
same,62,close,114,203,0.305418719,265
verdot,65,who,119,213,0.305164319,278
peel,90,without,160,296,0.304054054,386
perfumed,113,purity,203,372,0.303763441,485
petit,65,tension,119,214,0.303738318,279
smooth,208,noir,374,686,0.303206997,894
reveal,20,nacional,38,66,0.303030303,86
displays,23,explosive,46,76,0.302631579,99
home,13,difficult,26,43,0.302325581,56
focus,29,shiraz,57,96,0.302083333,125
zest,103,menthol,184,341,0.302052786,444
remains,32,essence,63,106,0.301886792,138
support,38,underlying,72,126,0.301587302,164
essence,19,integrate,37,63,0.301587302,82
earth,151,way,275,502,0.300796813,653
beer,15,complemented,31,50,0.3,65
contrast,15,chaparral,30,50,0.3,65
manages,12,bubbles,23,40,0.3,52
example,26,verve,52,87,0.298850575,113
juicy,315,pear,558,1055,0.298578199,1370
full,319,full-bodied,566,1070,0.298130841,1389
expensive,14,minutes,27,47,0.29787234,61
dried,266,alongside,464,898,0.296213808,1164
coconut,31,terroir,60,105,0.295238095,136
sure,18,clay,36,61,0.295081967,79
mingle,18,century,35,61,0.295081967,79
sonoma,20,state,38,68,0.294117647,88
old,73,variety,136,249,0.293172691,322
layering,12,gris,23,41,0.292682927,53
so,268,showing,470,918,0.291938998,1186
entry,14,hay,28,48,0.291666667,62
california,48,region,91,165,0.290909091,213
',18,feral,36,62,0.290322581,80
yeast,29,might,58,100,0.29,129
well,374,herb,645,1291,0.289697909,1665
smoke,111,quite,200,384,0.2890625,495
ripe,873,texture,1385,3026,0.28849967,3899
line,34,eight,66,118,0.288135593,152
vintages,25,plays,50,87,0.287356322,112
compact,28,potpourri,54,98,0.285714286,126
road,12,acres,24,42,0.285714286,54
expression,64,slate,118,225,0.284444444,289
mouthfilling,13,mace,25,46,0.282608696,59
wines,121,tannin,217,429,0.282051282,550
bracing,26,components,51,93,0.279569892,119
marmalade,19,dominant,37,68,0.279411765,87
fermented,24,tomato,48,86,0.279069767,110
apparent,12,ner,24,43,0.279069767,55
totally,27,include,53,97,0.278350515,124
inviting,38,iris,74,137,0.277372263,175
mushrooms,19,needing,37,69,0.275362319,88
:,85,nutmeg,151,310,0.274193548,395
combine,34,pinots,66,124,0.274193548,158
aromatic,108,wonderful,192,394,0.274111675,502
elements,57,remains,106,209,0.272727273,266
earthiness,18,18,35,66,0.272727273,84
lingers,28,candy,55,103,0.27184466,131
beginning,19,notion,38,70,0.271428571,89
allow,16,feet,33,59,0.271186441,75
black-plum,13,near-perfect,26,48,0.270833333,61
area,13,amid,25,48,0.270833333,61
mellow,23,moment,44,85,0.270588235,108
wrapped,40,range,76,148,0.27027027,188
subtle,82,such,145,304,0.269736842,386
such,39,muscular,74,145,0.268965517,184
life,29,riper,58,108,0.268518519,137
considerable,30,lithe,58,112,0.267857143,142
needs,106,2025,188,397,0.267002519,503
known,16,lushness,32,60,0.266666667,76
extra,34,seamlessly,66,128,0.265625,162
second,17,9,34,64,0.265625,81
add,40,enormous,76,151,0.264900662,191
coast,16,exhibits,31,61,0.262295082,77
everything,27,enhanced,53,103,0.262135922,130
black-cherry,22,darker,44,84,0.261904762,106
parts,17,source,34,65,0.261538462,82
worth,20,burnt,39,77,0.25974026,97
mocha,102,excellent,180,393,0.259541985,495
cedar,104,sandalwood,184,401,0.259351621,505
leather,193,mouthfeel,356,745,0.259060403,938
layer,22,long-lasting,43,85,0.258823529,107
25,15,mostly,30,58,0.25862069,73
lift,41,rind,78,159,0.257861635,200
yellow,104,star,184,405,0.256790123,509
both,110,soil,200,431,0.255220418,541
tobacco,185,cranberry,338,725,0.255172414,910
components,13,producers,26,51,0.254901961,64
boasts,40,pith,76,157,0.25477707,197
root,17,rest,34,67,0.253731343,84
2011,19,exceptionally,38,75,0.253333333,94
fragrant,59,barrels,109,234,0.252136752,293
beef,38,la,73,151,0.251655629,189
grippy,25,filling,50,100,0.25,125
range,19,drying,38,76,0.25,95
turned,13,kept,27,52,0.25,65
verve,13,reds,26,52,0.25,65
one,225,aromatic,394,908,0.247797357,1133
plums,49,aromatics,92,199,0.246231156,248
adding,18,display,35,74,0.243243243,92
small,33,harmonious,64,136,0.242647059,169
cool-climate,16,sexy,32,66,0.242424242,82
assertive,23,bursts,45,95,0.242105263,118
providing,15,supporting,29,62,0.241935484,77
structure,328,minerality,578,1369,0.239590942,1697
experience,21,extraction,41,88,0.238636364,109
barrels,26,whose,51,109,0.23853211,135
2008,14,perfumes,28,59,0.237288136,73
full-bodied,134,quality,237,566,0.236749117,700
year,57,evolve,105,241,0.236514523,298
longer,24,tough,48,102,0.235294118,126
persistent,16,begins,33,68,0.235294118,84
loads,16,follow,32,68,0.235294118,84
hearty,16,influence,31,68,0.235294118,84
freshness,173,subtle,304,736,0.235054348,909
keeping,18,molasses,36,77,0.233766234,95
blossom,37,chalk,71,159,0.232704403,196
will,351,impressive,610,1515,0.231683168,1866
youthful,28,swathes,55,121,0.231404959,149
world,15,selected,30,65,0.230769231,80
mousse,15,sings,29,65,0.230769231,80
mature,74,inviting,137,321,0.230529595,395
including,17,spring,34,74,0.22972973,91
richer,19,knit,37,83,0.228915663,102
savory,144,focused,258,630,0.228571429,774
clove,138,top,245,605,0.228099174,743
from,1163,%,1831,5112,0.227503912,6275
drive,12,2037,25,53,0.226415094,65
reserve,21,shy,41,93,0.225806452,114
lends,14,spent,28,62,0.225806452,76
wild,141,2019,256,626,0.225239617,767
most,81,little,145,363,0.223140496,444
grown,26,s,51,117,0.222222222,143
youth,12,hardly,24,54,0.222222222,66
meat,63,exceptional,115,284,0.221830986,347
almonds,13,offset,26,59,0.220338983,72
100,66,deeply,121,300,0.22,366
between,49,keeps,93,223,0.219730942,272
sense,56,itself,103,256,0.21875,312
need,37,nice,71,170,0.217647059,207
coastal,15,80,29,69,0.217391304,84
top,53,chalky,98,245,0.216326531,298
inky,16,bitterness,32,74,0.216216216,90
young,139,body,245,649,0.214175655,788
their,37,viognier,72,173,0.213872832,210
barrel,87,aftertaste,154,407,0.213759214,494
aged,56,meaty,103,263,0.212927757,319
2016,30,pastry,58,141,0.212765957,171
always,29,well-integrated,57,137,0.211678832,166
cinnamon,124,between,223,586,0.211604096,710
atop,12,24,24,57,0.210526316,69
balances,13,recall,25,62,0.209677419,75
best,163,textured,295,778,0.209511568,941
many,75,cab,140,358,0.209497207,433
alongside,97,need,170,464,0.209051724,561
improve,28,2026,57,134,0.208955224,162
reveals,20,explosion,38,96,0.208333333,116
vivid,15,recent,31,72,0.208333333,87
bottle,89,enjoy,158,428,0.207943925,517
fig,25,fantastic,49,121,0.20661157,146
whiff,51,immense,95,247,0.206477733,298
rare,13,definitely,26,63,0.206349206,76
vintage,162,franc,294,786,0.20610687,948
15,27,truly,53,132,0.204545455,159
how,21,maybe,41,103,0.203883495,124
french,47,slender,90,231,0.203463203,278
unfold,15,deeper,30,74,0.202702703,89
wait,24,hours,47,119,0.201680672,143
asian,24,nut,47,119,0.201680672,143
together,67,selection,123,337,0.198813056,404
above,16,foundation,33,81,0.197530864,97
2007,14,cult,28,71,0.197183099,85
selection,24,chardonnays,47,123,0.195121951,147
fine,180,valley,332,923,0.195016251,1103
still,194,vibrant,356,1000,0.194,1194
?,490,intense,823,2547,0.192383196,3037
intensity,72,pipe,132,375,0.192,447
liqueur,18,astringent,35,94,0.191489362,112
peppercorn,18,immediate,35,94,0.191489362,112
nervy,13,senses,26,68,0.191176471,81
menthol,35,marmalade,68,184,0.190217391,219
potent,13,change,26,69,0.188405797,82
core,107,too,190,568,0.188380282,675
grace,16,profound,33,85,0.188235294,101
linear,16,feeling,32,85,0.188235294,101
laced,16,wraps,32,85,0.188235294,101
black,686,chocolate,1114,3656,0.187636761,4342
valley,62,deliciously,114,332,0.186746988,394
textured,55,high-toned,102,295,0.186440678,350
spices,86,underbrush,151,462,0.186147186,548
pine,28,hot,55,151,0.185430464,179
petal,21,dark-skinned,40,114,0.184210526,135
additional,16,key,32,87,0.183908046,103
meyer,15,2013,29,82,0.182926829,97
supported,15,howell,29,83,0.180722892,98
last,28,nearly,57,155,0.180645161,183
certainly,32,amount,62,178,0.179775281,210
purple,36,allspice,69,201,0.179104478,237
delivers,96,five,170,539,0.178107607,635
salt,17,2006,33,96,0.177083333,113
streamlined,12,complement,23,68,0.176470588,80
intensely,31,historic,60,176,0.176136364,207
eucalyptus,22,home,43,125,0.176,147
every,18,restraint,36,103,0.174757282,121
river,15,house,30,86,0.174418605,101
allspice,12,pomegranates,25,69,0.173913043,81
meld,12,sizzling,23,69,0.173913043,81
frame,20,2040,39,118,0.169491525,138
cigar,12,san,24,71,0.169014085,83
producer,40,pleasure,77,238,0.168067227,278
these,28,buttery,55,167,0.167664671,195
depth,77,tastes,142,461,0.1670282,538
sea,16,passion,32,96,0.166666667,112
richness,128,balsamic,233,770,0.166233766,898
10,53,promises,99,319,0.166144201,372
sip,44,2012,86,265,0.166037736,309
sage,37,flesh,70,224,0.165178571,261
me,17,study,33,103,0.165048544,120
time,137,year,241,833,0.164465786,970
concentration,99,no,174,602,0.164451827,701
la,12,dances,24,73,0.164383562,85
boysenberry,25,2032,50,153,0.163398693,178
after,88,sourced,155,540,0.162962963,628
restrained,20,proportion,39,123,0.162601626,143
another,31,maple,62,193,0.160621762,224
balanced,164,peel,296,1022,0.160469667,1186
2010,15,tasting,29,27,0.555555556,42
dark,295,opens,532,1854,0.159115426,2149
anise,70,pencil,127,440,0.159090909,510
each,17,extract,33,107,0.158878505,124
steely,27,lasts,52,170,0.158823529,197
through,284,generous,505,1795,0.15821727,2079
licorice,150,flower,269,952,0.157563025,1102
easily,19,rioja,37,121,0.157024793,140
combines,19,moderate,37,121,0.157024793,140
new,119,petit,214,758,0.156992084,877
already,63,something,116,402,0.156716418,465
release,18,captivating,35,115,0.156521739,133
appellation,32,residual,63,205,0.156097561,237
winery,56,densely,104,359,0.155988858,415
yet,144,integrated,258,927,0.155339806,1071
play,18,major,35,116,0.155172414,134
cassis,113,purple,201,741,0.152496626,854
meet,16,textbook,31,105,0.152380952,121
future,22,standout,42,145,0.151724138,167
glass,72,pie,133,477,0.150943396,549
promise,17,toned,34,113,0.150442478,130
become,12,winemakers,24,80,0.15,92
four,16,using,32,108,0.148148148,124
five,25,beer,50,170,0.147058824,195
family,24,development,48,164,0.146341463,188
mouthwatering,19,grounds,37,130,0.146153846,149
modern,17,effect,33,117,0.145299145,134
ginger,18,somewhat,34,124,0.14516129,142
exotic,53,butter,99,369,0.143631436,422
hold,36,present,70,251,0.143426295,287
length,37,2007,71,258,0.143410853,295
firm,192,vineyards,355,1343,0.142963515,1535
3,15,sizable,29,105,0.142857143,120
linger,14,veteran,27,98,0.142857143,112
stage,21,releases,40,148,0.141891892,169
2012,12,immaculate,24,26,0.461538462,38
produced,35,sonoma,68,251,0.139442231,286
should,108,2025,193,780,0.138461538,888
bold,43,linear,85,312,0.137820513,355
lingering,39,crafted,74,283,0.137809187,322
intriguing,19,custard,38,138,0.137681159,157
mineral,109,another,193,794,0.137279597,903
heart,14,colored,27,102,0.137254902,116
nuances,16,brand,32,118,0.13559322,134
three,15,captures,30,111,0.135135135,126
forest,38,price,73,283,0.134275618,321
provide,40,near,77,301,0.132890365,341
named,15,firmness,29,113,0.132743363,128
loaded,20,nothing,39,151,0.132450331,171
aging,127,what,227,960,0.132291667,1087
e,23,soils,44,174,0.132183908,197
ever,14,prime,28,106,0.132075472,120
complexity,85,acids,150,646,0.131578947,731
complete,16,kicks,33,122,0.131147541,138
rose,64,within,117,493,0.129817444,557
perfectly,19,subdued,37,147,0.129251701,166
finesse,27,gravel,54,209,0.129186603,236
against,20,past,39,155,0.129032258,175
cr,13,massively,26,101,0.128712871,114
5,27,develops,52,210,0.128571429,237
within,15,ends,30,117,0.128205128,132
satisfying,12,medium-sweet,23,94,0.127659574,106
de,21,case,40,166,0.126506024,187
lifted,18,touched,35,144,0.125,162
perfect,23,meats,45,185,0.124324324,208
deep,67,2015,122,539,0.124304267,606
deeply,15,screwcap,30,121,0.123966942,136
minerals,15,edged,30,122,0.12295082,137
sourced,19,tons,37,155,0.122580645,174
supple,30,raw,58,245,0.12244898,275
smoked,23,gingerbread,45,189,0.121693122,212
intense,100,slowly,175,823,0.121506683,923
huge,19,noble,37,159,0.119496855,178
packed,42,pears,82,356,0.117977528,398
blue,29,explodes,57,246,0.117886179,275
rich,304,delivers,539,2589,0.117419853,2893
2017,25,incense,49,217,0.115207373,242
plush,21,mixed,40,183,0.114754098,204
espresso,24,leads,48,215,0.111627907,239
several,18,expansive,36,164,0.109756098,182
classic,34,bring,65,313,0.108626198,347
lush,46,elderberry,88,439,0.104783599,485
napa,21,generously,41,201,0.104477612,222
sandalwood,19,superripe,37,184,0.10326087,203
firmly,17,maturing,33,166,0.102409639,183
continue,13,stuffing,25,127,0.102362205,140
elegance,40,luxurious,77,395,0.101265823,435
vibrant,36,nectarine,69,356,0.101123596,392
floor,19,acid,37,188,0.10106383,207
bottling,65,wait,119,653,0.099540582,718
nutmeg,15,briary,30,151,0.099337748,166
density,20,balsam,39,206,0.097087379,226
age,115,density,206,1206,0.095356551,1321
pencil,12,savoriness,24,127,0.094488189,139
crushed,57,bay,105,606,0.094059406,663
cake,13,phenolic,26,142,0.091549296,155
pure,43,real,85,473,0.090909091,516
framed,17,kirsch,33,191,0.089005236,208
minerality,51,assertive,95,578,0.088235294,629
pomegranate,18,shot,35,204,0.088235294,222
great,99,really,174,1208,0.081953642,1307
balsamic,19,bergamot,37,233,0.081545064,252
generous,40,marked,76,505,0.079207921,545
serious,18,ava,35,232,0.077586207,250
estate,32,reminiscent,63,419,0.076372315,451
further,14,pairing,27,184,0.076086957,198
soil,15,component,31,200,0.075,215
until,22,parcels,42,294,0.074829932,316
violets,12,utter,23,162,0.074074074,174
layers,41,extracted,78,567,0.072310406,608
dense,81,seductive,144,1126,0.071936057,1207
integrated,18,incredible,35,258,0.069767442,276
next,29,steak,57,420,0.069047619,449
purity,14,deftly,28,203,0.068965517,217
violet,22,rise,42,321,0.068535826,343
thyme,15,dusting,29,224,0.066964286,239
winemaker,17,date,33,265,0.064150943,282
taut,15,atlas,30,238,0.06302521,253
structured,67,petals,123,1070,0.062616822,1137
long,68,eucalyptus,125,1109,0.061316501,1177
vines,21,sparkling,40,349,0.06017192,370
vineyards,21,gain,42,355,0.05915493,376
layered,23,immensely,45,400,0.0575,423
tightly,14,solidly,27,253,0.055335968,267
vineyard,67,complete,122,1220,0.054918033,1287
elegant,47,lend,90,864,0.054398148,911
focused,14,re,28,258,0.054263566,272
potential,21,expect,40,390,0.053846154,411
least,25,brightened,49,480,0.052083333,505
power,35,ch,67,676,0.051775148,711
develop,28,caramelized,55,542,0.051660517,570
years,92,followed,163,1781,0.051656373,1873
?,2648,black,3656,358,7.396648045,3006
lovely,20,luminous,40,418,0.04784689,438
baking,16,obviously,32,364,0.043956044,380
polished,16,pulls,31,383,0.041775457,399
concentrated,55,heart,102,1340,0.041044776,1395
complex,42,oregano,82,1106,0.037974684,1148
powerful,32,minerally,63,850,0.037647059,882
delicious,37,syrup,71,1024,0.036132813,1061
cellar,15,seemingly,30,445,0.033707865,460
beautiful,14,jelly,27,571,0.024518389,585